的	u
一	f
是	o
不	c
了	r
在	n
我	t
人	j
他	je
这	vu
有	nv
个	jg
大	m
上	yf
中	d
来	a
地	ge
和	x
说	s
为	i
们	ja
到	y
你	jx
就	g
也	e
以	vj
国	rn
国	rni
那	au
要	v
时	ok
出	sm
着	gq
可	z
道	h
之	ri
对	rk
会	jb
自	oi
而	l
得	w
下	fy
能	k
过	ku
生	ls
子	hi
于	fn
年	ev
后	xf
发	sr
发	sri
都	q
里	dl
没	kr
还	cu
所	mt
去	gk
看	uq
事	fd
如	b
用	ty
小	yx
作	jw
多	ll
行	p
只	dh
好	bh
成	na
家	wj
天	fm
她	be
方	lf
然	vm
然	vmc
当	yb
心	hx
起	pv
种	xd
种	xdg
想	eqh
经	ir
现	ne
但	jo
法	kg
法	kgk
无	du
同	mf
同	mfd
么	tk
进	qu
学	kw
面	bm
其	zh
前	hv
已	vi
主	in
从	jj
动	bs
分	hp
把	umb
开	fl
军	wyc
又	ry
两	ml
本	ef
因	rm
定	wt
部	id
部	idt
与	fa
将	alk
日	or
长	pc
理	ndl
三	ts
些	svm
实	ww
实	wwm
样	egy
十	ns
意	xh
知	od
此	sv
第	rt
力	sl
很	wi
正	fsi
高	gg
手	us
什	jns
身	zs
被	tr
它	wv
明	ov
老	ql
者	qo
公	hk
见	ej
机	eo
向	tm
问	adk
最	oq
最	oqr
使	jf
使	jfd
全	jn
点	yd
点	ydc
情	ha
外	lyb
民	dm
并	hl
战	ydp
关	hmd
工	ug
回	rd
等	rg
等	rgk
相	eqm
二	me
重	ldl
由	dy
头	wm
声	gc
性	hls
应	xk
应	xkf
间	ao
话	sa
文	vw
给	ij
给	ijd
美	gm
业	cy
物	qne
真	nq
体	jef
或	pdf
政	fsh
几	oj
内	mj
利	xp
打	ua
走	pz
新	ie
新	iet
位	ji
西	vx
再	fmg
产	ixc
加	sd
月	vy
却	gkz
先	qp
制	qrp
特	qg
特	qgk
果	qem
东	ryx
神	fog
儿	pe
才	nt
门	am
太	mi
合	jdk
信	js
表	ati
原	xu
女	bn
更	fo
更	fob
己	vjj
名	ld
立	il
比	vv
代	jp
四	ys
斯	zht
任	jt
次	we
世	la
便	jfo
听	dtj
提	uo
提	uot
做	jc
海	kek
水	ks
教	qhh
眼	qi
化	jvb
通	kt
通	ktu
感	nf
王	nw
各	sg
口	dk
气	vq
别	ds
别	dsp
少	yt
处	hy
平	eh
常	srj
解	xt
何	jz
接	uib
目	qm
反	xr
变	zc
变	zcr
笑	rtm
总	hd
总	hdh
入	ju
认	sj
条	he
安	wb
金	zj
及	cj
度	xlr
让	syf
山	vs
马	nm
受	ywr
活	ka
结	igd
数	pb
数	pbh
直	nqf
必	ht
白	ub
指	uv
指	uvo
张	bp
报	uz
论	sjl
员	do
义	ib
放	lh
电	oa
至	yi
五	wu
系	tis
难	rui
命	jdz
建	bu
尔	xyx
件	jq
死	gv
保	jde
完	wmp
许	se
许	sen
题	ot
题	otw
场	ga
空	eu
计	sn
怎	wh
光	mg
管	rwk
非	rf
德	wn
德	wny
强	bd
量	ofd
决	wnj
形	fle
像	jwx
期	zhv
资	weo
队	tjr
清	kav
务	hs
嗯	dr
统	ibp
书	aa
书	aag
市	zr
司	afd
师	pf
师	pfr
住	jin
即	iz
克	cp
带	lw
带	lwr
飞	cf
南	nmg
区	nb
李	ehi
则	op
觉	kwe
交	ab
社	fg
今	jae
基	zhg
北	av
展	cl
展	clt
传	jm
传	jma
连	yu
叫	di
治	kk
治	kkd
路	psg
万	fp
告	qd
科	xj
呢	dcv
思	qh
达	mu
记	svj
转	ym
转	yma
望	fv
望	fvn
边	su
快	hn
快	hnj
风	obi
色	xm
该	sk
界	qjp
象	wx
权	er
拉	ui
设	srs
且	fq
取	qr
干	eg
收	ih
步	ssi
领	jkw
林	ee
根	ei
往	win
亲	iem
极	ec
求	fk
未	aw
每	ek
程	xdn
式	pug
兵	thb
据	uc
据	ucc
类	pmd
言	sy
规	hej
吧	dmb
品	ddd
确	mx
确	mxt
观	rej
城	gna
虽	dc
失	th
格	es
远	mp
远	mpu
办	sh
元	mpe
运	buc
令	jks
共	lhb
似	jvj
准	wui
请	sav
武	fps
士	gs
改	vh
英	lm
术	eid
车	yc
石	ms
深	kwh
联	qhm
争	xb
吗	dn
院	tw
院	twm
轻	yr
轻	yru
火	ch
罗	yl
百	fu
夫	hf
离	zb
花	lj
花	ljv
近	tu
切	rpd
识	sdh
造	qdu
组	if
流	kb
流	kbo
算	rql
布	nrj
导	vk
早	on
找	up
候	jgn
满	kl
满	klm
服	vz
官	wk
整	xhf
爱	yw
爱	ywn
字	whi
持	ugk
跟	pig
突	emq
影	og
消	kyv
随	tn
吃	de
吃	dea
商	im
证	sf
证	sfs
单	hq
议	sib
越	pn
存	ng
存	ngh
击	um
精	pa
精	pav
济	kqq
始	bkd
台	kd
黑	ph
调	smg
需	tle
支	ci
杀	bem
团	rnt
功	usl
具	qhb
华	jvn
脸	vjk
府	xjk
集	ue
周	mgd
青	avy
红	iug
双	rr
九	kj
八	hb
片	ap
半	hu
容	whg
曾	hr
啊	dt
啊	dtz
阿	tz
落	lk
落	lks
显	ocy
除	tjx
尽	ciw
党	spe
照	opd
众	jjj
备	hqt
复	eoh
陈	try
断	pat
价	jjp
约	ini
写	wf
写	wfa
包	nvs
级	icj
另	dsl
病	afm
质	xno
称	xxy
倒	jy
倒	jyp
江	kug
绝	ixm
敌	ah
黄	nh
技	uci
六	al
朝	no
派	kx
派	kxt
线	ifp
站	iyd
究	ekj
装	agti
亚	fcy
首	ho
刚	mbp
示	fs
视	fe
况	wd
况	wdp
增	ghr
谈	sc
谈	scc
惊	hgy
古	cg
史	db
谁	sui
引	bgs
须	ew
七	rq
息	ohx
研	mfl
际	tfs
器	dd
易	one
留	bq
推	uu
坐	jjg
房	mlf
广	xg
注	ki
注	kin
查	eof
语	sw
语	swd
念	jah
若	lnd
奇	mzk
紧	pr
企	jsi
希	bnr
委	xbn
响	dtm
号	df
参	kme
势	ukis
历	xsl
剑	jkf
攻	uh
冷	wjk
投	urs
哪	dau
农	wti
专	ma
专	mai
图	rhw
考	qf
考	qfa
选	qpu
终	ihw
微	wvf
皇	un
土	gt
局	cad
星	ol
足	pu
刘	vp
甚	zha
严	fcx
医	nos
男	qsl
营	lwd
乎	thn
仅	jr
父	hbi
拿	jdu
孩	hkh
答	rjd
费	to
标	efs
依	jti
兴	khb
低	jbi
千	lq
仍	jv
急	xbh
护	umh
竟	xpe
某	ze
较	yab
防	tlf
列	gp
讲	sq
破	mr
客	ws
施	le
施	lee
故	chp
血	tam
节	lz
云	by
龙	tl
钱	zf
钱	zfp
苏	lsh
母	km
伤	jes
举	khu
族	leo
按	uwb
维	iu
修	jgh
帝	iwr
河	kz
威	nfb
巴	mb
划	pp
致	yh
案	wbe
革	tg
底	xbi
送	hm
送	hmu
冲	wdg
音	xy
态	mih
够	gl
够	gll
段	uf
段	ufr
构	enk
群	bt
船	iod
责	aob
苦	lcg
章	xns
律	wbv
愿	xuy
围	rgw
京	gyx
衣	ti
喜	hdk
独	mc
效	abh
斗	jd
细	iq
怕	hub
志	gh
米	pm
晚	owp
热	uk
项	uw
料	pj
例	jgp
灵	bch
密	wht
害	wadk
供	jlh
属	ct
属	ctd
验	nj
境	gx
境	gxp
毛	vmm
般	irs
居	ccg
继	ip
继	ipa
错	zl
错	zlo
沉	kwo
采	ye
既	idu
察	whf
否	cd
批	uvv
脑	vzb
夜	zjv
股	vr
速	xuc
纪	ivj
续	ina
假	jcm
帮	at
帮	atr
乐	byx
陆	tum
型	flpg
退	iuc
友	nr
铁	zt
铁	zth
汉	kry
暗	ox
状	amq
左	nu
句	gj
雷	tqt
网	mbb
率	zi
值	jnq
普	hco
承	ak
停	jga
试	sp
弹	bhq
止	si
职	qdh
药	li
药	lin
久	xi
印	bfz
卫	zfi
助	fsl
掌	sus
织	idh
阳	tor
待	wgk
初	tpd
追	tku
木	em
哈	dj
您	jxy
预	iw
刻	kp
创	jzp
诉	st
简	ra
简	rao
射	zk
射	zkc
限	tig
球	nfk
差	gu
树	erk
校	eab
兰	hts
怪	hrg
阵	tyc
异	vl
宗	wfs
波	krp
育	bvy
激	kul
担	uof
顿	fsw
游	kle
充	bpe
银	zig
适	auc
省	ytq
胡	cvy
食	qs
警	lg
素	ais
尼	cvb
排	ur
负	xo
背	avv
忽	neh
酒	ky
穿	el
福	ff
福	ffd
弟	htf
怀	hc
欢	re
环	nc
招	upd
模	elo
胜	vls
痛	akt
习	zx
险	tjkf
财	ont
益	kam
宝	wni
脚	vg
疑	vo
疑	vok
乱	aae
赶	peg
坚	prg
获	lmm
劳	lws
挥	uwy
敢	aqh
置	yn
置	ynq
右	nd
压	xgi
香	xor
层	cb
略	qsg
静	avx
村	ekc
范	lkz
源	kxu
副	fdq
州	oo
纳	imj
岁	vlx
罪	yrf
余	jxh
闻	aq
占	ydk
玉	ni
哥	zz
杨	ea
忙	hfw
兄	dp
守	wkc
跑	pnv
述	eiu
座	xjj
田	qt
摇	uyaf
超	ppd
演	kwfh
皮	rp
喝	don
买	awm
佛	jtf
室	wyi
角	xty
卡	yfy
封	ggk
策	remk
块	gn
块	gnj
富	wfd
判	hup
配	yv
姑	bc
优	joy
征	wfsi
善	ghd
刀	pd
娘	bi
娘	bii
降	thv
恶	fchx
宣	wfo
慢	hoyr
积	xdh
草	lo
恐	uoih
妈	bnm
读	snam
靠	qdr
阶	tjp
楚	eet
姐	bf
爸	hbm
执	uki
呼	dth
协	nsh
洲	koo
巨	nn
免	wp
检	ejk
养	gi
养	gip
顾	xz
顾	xzw
救	fki
份	jh
份	jhp
控	ueu
抗	uzo
著	lqo
赵	pbi
肯	svy
露	tps
换	ux
换	uxm
登	hz
伊	jbt
犯	mz
尚	ss
莫	lom
危	xx
危	xxz
审	wo
审	wog
掉	uy
掉	uyo
亦	zch
沙	kyt
散	lv
欧	nbe
唐	xbd
枪	ejz
宫	wdd
魔	za
耳	qe
屋	cyi
永	ik
孙	hyx
临	pro
圣	rgt
叶	dns
毫	gvm
宋	wem
谢	sz
讨	skc
温	koa
嘴	dsv
航	izo
毒	akm
呀	dly
野	div
逃	pw
托	utr
伯	jub
索	nwi
岛	xv
贵	co
顺	ow
楼	ep
楼	epb
遇	qv
遇	qvu
良	ii
朋	vvy
坏	gcb
亮	go
户	mh
景	ogy
烈	gpc
闪	aj
礼	fae
艺	lai
互	fb
丝	iis
秘	xht
渐	kytj
架	sde
鱼	wvv
升	tlc
抓	uya
监	pra
君	btd
短	oz
梦	eel
隐	tx
隐	txb
困	rem
税	xhd
洋	kgy
鬼	ag
炮	cnv
炮	cn
舰	iej
付	jk
诸	sqo
货	jvo
松	ehk
归	pbj
败	oh
幸	ggy
概	eidu
寻	bkc
评	seh
吸	dcj
恩	rmh
介	jpd
朱	ta
探	uwh
县	fks
脱	vhd
移	xll
缺	an
缺	anj
画	fqmk
误	sdf
释	tpr
旁	iwl
跳	ppw
藏	lnq
春	aio
睡	qll
吉	gdk
端	ivl
味	da
杂	ke
翻	tp
雪	tb
遗	cou
款	gf
款	gfe
刺	emp
附	tjk
爷	hbz
核	ekh
央	mm
减	wnf
阴	tvy
编	imi
版	ax
版	axr
智	odo
齐	qq
雨	tv
徐	wjx
鲁	wor
仙	jvs
湖	kcv
钟	zdg
蒙	lwf
丽	fvv
班	np
咱	doi
康	xbk
损	udo
震	tfc
借	jlo
固	rc
诗	sgk
镇	znq
吴	dfm
域	gpd
均	gnw
秦	aix
妇	bb
鲜	wgy
序	xiv
烟	cr
烟	crm
洞	kmf
猛	mha
测	ko
测	kop
练	iry
旧	gor
堂	sgt
笔	rv
饭	qx
顶	awy
灭	fch
庄	xgt
括	uas
怒	brh
补	tyb
逐	juc
毕	vvns
席	xlrj
禁	eef
剧	ccp
乡	ixx
湾	kzc
卖	naw
牛	qn
避	cdnu
欲	heq
弄	nl
忍	pih
旅	let
暴	olh
虚	zcy
额	wsw
含	jad
忘	fh
抱	unv
油	kdy
肉	mjj
输	yjv
洛	ksg
祖	ffq
缓	iyf
迎	bz
迎	bzu
虎	zhh
票	vf
销	zyv
销	zy
婚	bbo
乃	vn
板	exr
冰	wks
伸	jog
录	bk
遍	miu
虑	zhx
宁	wad
臣	qc
玩	nmp
熟	ghk
谷	hg
予	iv
谋	sze
炸	cw
督	yfyq
奥	tmpm
狂	mnw
亡	fw
港	klhv
庭	xtg
博	nnk
材	ent
俄	jtu
韩	non
混	kov
词	saf
盘	ia
尊	hyk
寒	wq
遭	fyou
训	so
拍	uub
麻	zm
荣	lwe
卷	hh
卷	hhz
夏	foh
谓	sqv
凡	oid
私	xks
厂	xc
丁	ad
骨	fgg
牙	ly
休	jem
迫	uuc
授	uyw
替	hho
拥	ut
摆	uyg
默	pmq
勒	tsl
泽	kru
骑	nmz
疗	ar
睛	qa
睛	qav
店	xyd
载	npy
诺	sln
健	jbu
扬	uaes
纸	ibs
透	xvu
床	xe
唯	dui
岸	vxe
迅	anu
尤	oy
稳	xxb
园	rmp
徒	wpz
伦	jjl
坦	gof
择	uru
蓝	lp
蓝	lpr
握	ucy
抵	ubi
姓	bls
郑	hmt
弱	bw
弱	bwb
软	yeq
绿	ibk
叹	dry
轮	yj
束	xs
盖	gam
丈	fbi
篇	rmi
午	en
窗	et
歌	zze
雄	nk
雄	nku
森	eee
醒	yo
醒	yol
伙	jch
残	gfp
戏	rpg
妻	fbb
折	utj
甲	sjj
啦	duil
套	mpc
塔	glj
馆	qwk
秋	xch
梅	eek
迷	puc
典	ihb
灯	ca
厉	xfp
秀	xvn
扩	uxg
曲	yq
努	br
努	brs
潜	khh
街	pgg
硬	mfo
宇	wfn
哭	ddm
阻	tfq
萨	lt
萨	lti
纵	ijj
喊	dnfd
搞	ugg
冒	oqm
罢	ygk
盛	naa
塞	wqhg
妹	ba
萧	lbp
桌	yoe
圆	rdo
纷	ihp
悲	rh
鼓	hci
淡	kcch
访	slf
础	msm
杜	egt
宽	wl
宽	wle
拜	ufa
犹	mo
抽	udy
刑	flp
偏	jmi
奔	mnl
侵	jbw
延	tsu
懂	hll
蒋	lal
针	zn
抬	ukd
舞	elfv
赞	qpq
侧	jop
赛	wqh
纯	ifs
申	ogs
夺	mk
柳	eb
距	pnn
丹	mzt
仿	jlf
川	oc
途	jxu
曹	fyo
购	onk
亿	jai
乌	xuu
胸	vnb
浪	kii
贝	ob
偷	jjv
姆	bkm
竞	idp
茶	lje
末	fem
毁	pur
烧	cpf
伟	jgw
库	xyc
弃	blc
墙	ggh
雅	lu
贸	bo
沿	kod
爆	col
振	ufc
趣	pq
趣	pqr
操	udd
诚	sna
挑	upw
杰	ech
轰	yrr
盟	ova
勇	kts
敬	lgh
狗	mgj
恨	hig
迹	zcu
呆	dem
疾	aos
哲	utd
促	jpu
麦	ahi
横	enh
丰	af
闭	ant
撤	ubv
析	etj
挂	uggt
彩	yee
埃	gko
召	pdk
童	idl
摩	zu
乘	xav
符	rjk
筑	ruo
眉	cq
侠	jhhb
袭	tt
孤	hyg
培	gid
耶	qte
染	kke
稍	xyv
妙	byt
凶	bmk
页	wy
戴	npq
洗	kqp
陷	txp
络	is
络	isg
植	enq
厚	xoh
措	ulo
瓦	rw
援	uyf
汇	kn
触	xtc
售	ud
违	guc
粮	pii
泪	kq
彻	wr
洪	klh
献	nmgm
魂	bag
抢	ujz
玄	ziy
巧	ufae
珠	nta
劲	rus
彼	wrp
摸	ul
凭	jtg
暂	yto
碰	mhc
皆	vvu
尖	ymd
忠	dgh
奉	aiu
享	ghi
聚	qrt
胆	vof
厅	xad
闹	az
闹	azr
灰	nch
津	kbv
倾	jvw
订	sad
鸟	xn
扑	uyb
孔	hae
汽	kv
吓	dfy
驻	nin
叔	yfyr
凤	ory
紫	svi
妖	btm
凌	wgh
唱	doo
梁	kph
箭	rhv
融	ncc
殊	gta
课	sqe
莱	lah
奴	bry
扫	ubj
肩	mv
鼻	oql
庆	xmd
镜	zxp
菜	lye
恢	hnc
御	waz
烦	cwy
裁	npt
估	jcg
隔	tng
尸	cs
尾	cv
仪	jib
瞧	quc
迟	ciu
圈	rhh
译	sru
骂	ddn
珍	nje
币	trj
惨	hkm
剩	xa
愈	jvph
飘	vfo
荒	lfo
惯	hko
缘	ibj
曼	oyr
舍	jas
季	xhi
旗	lez
艾	lbi
牌	aut
恰	hj
恰	hjd
废	xsr
腰	vvb
腿	viu
玛	nnm
累	qis
涉	kssi
燕	ldac
朗	iivy
颗	qew
签	rjkf
吹	deq
罚	ysp
拒	unn
仰	jbz
描	ulq
杯	ecb
奖	alm
奋	mqt
奶	bv
贫	hpo
甘	zg
婆	krb
繁	ekhi
穷	esl
伏	jmq
幕	lomr
殿	clhr
沈	kwp
绍	ipdk
启	md
缩	iwj
粗	pfq
弗	tf
患	ddgh
仇	jkj
债	jaob
碎	mzj
挺	utg
泰	aik
羊	gy
旋	lets
晓	opf
障	txn
桥	etm
仁	jme
郎	iit
孟	ham
讯	san
虫	cc
郭	ghte
幻	iae
赫	gcg
裂	gpt
凝	wvo
颜	ix
刊	epd
慈	hiih
吕	ddk
昨	owa
辛	nx
役	wrs
逼	fdqu
泛	ktr
瑞	nvl
伴	jhu
袁	gdt
翼	zq
舒	jaiv
宜	wfq
偶	jqv
峰	vha
径	wru
岂	vvj
潮	kno
捕	unf
辆	yml
邪	lte
症	afs
颇	rwy
插	ulp
袋	jpt
爬	ymb
掩	umo
霍	tui
浮	kyh
倍	jid
壮	ags
豪	gjs
拔	unr
拖	uee
渡	kxlr
悄	hyv
堆	gui
鸡	rx
狼	mii
播	utp
零	tjks
躲	zo
躲	zoe
映	om
映	omm
灾	wc
尺	cid
俗	jhg
疯	aobi
丧	ght
冬	hw
辩	nsn
炎	cch
咬	dab
码	mn
猜	mav
壁	cdng
艘	ipg
滚	kth
贴	oyd
赏	sob
劝	rs
兽	hqf
番	tpq
哼	dgr
撞	uid
伍	jwu
柔	ite
旦	ofi
跃	pt
跃	ptm
隆	thf
魏	xba
狠	mig
糊	pcv
扎	uae
忧	hoy
衡	pwv
帐	rpc
崇	vwf
汗	keg
赖	xxo
薄	lkn
净	wxb
粉	php
岩	vms
忆	hai
堡	jdeg
巡	ou
仔	jhi
欣	te
偿	jsb
愤	hnl
阁	asg
详	sgy
喵	dlq
竹	ru
漫	koy
爹	hbl
董	lld
撒	ulv
佩	jof
丢	tgk
绕	ipf
赤	gch
扶	uhf
蛋	tc
吐	dg
返	xru
闲	ae
陪	tidk
乔	tmp
盾	xnq
矿	mxg
矛	it
耐	lkc
焦	uch
侍	jgk
拳	hhu
墨	pgt
允	kpe
侯	jno
滑	kf
润	kan
胞	vnv
邦	ate
辈	ryc
井	qj
荷	ljzk
摄	uqr
署	yqo
荡	lka
敏	ekhp
递	htu
泥	kcvb
骗	nmi
曰	orr
彭	hes
租	xfq
晨	of
搜	upg
昏	bor
幅	rfd
奏	aif
幽	vii
兼	hbc
肃	bph
艇	itgu
辑	ydq
枝	eci
岳	tfv
黎	xpj
浓	kwti
酸	yk
酸	ykh
污	kma
凉	wg
辞	anx
嘛	dz
戒	pl
躺	zss
菲	lr
垂	llg
贯	kob
炼	cry
苍	ljz
箱	req
驾	sdn
驱	nnb
凯	vvoj
截	npu
埋	gdl
拼	uhl
涌	kkt
乏	tri
腾	vhh
悉	tph
冯	wnm
诊	sje
皱	xbr
桑	rrre
慧	aab
漂	kvf
蛇	cwv
恭	lhh
迪	duc
恋	zchx
侦	jyo
钢	zmb
氏	bss
贼	opn
燃	cvmc
饮	qeq
碍	mof
韦	gw
尘	ygt
餐	gr
餐	grq
邓	rte
阅	ahd
液	kzjv
欺	zhe
呵	dzk
牵	mwq
综	iwf
俩	jml
踪	pwf
殖	gnqf
趋	pxb
磨	zms
绪	iqo
锁	zyo
陶	tna
蒂	liw
慌	hlf
臂	cdnv
慕	lomh
晋	fco
卢	ycs
惠	nqk
储	jsq
汤	kae
宪	wqp
扰	uoy
宙	wdy
聪	qhd
怨	lzh
呈	dnw
跌	pth
匆	nei
铺	znf
脉	vik
锋	zhaf
劫	gks
芳	llf
宾	wth
帕	rub
盗	wea
佳	jgg
遵	hyku
哦	dtu
幼	isl
仗	jfb
伪	jis
驶	ndb
腹	veo
牧	qhp
踏	pk
踏	pko
惜	hlo
朵	oe
袖	td
胁	vsh
抛	uksl
霸	ttv
媒	bze
频	ssw
勃	nwhs
盯	qad
弯	zcb
抚	udu
扭	uagt
册	ic
励	xfps
颤	zrd
键	zbu
勤	lda
贡	uob
洁	kgd
怜	hjk
寿	akc
腊	vlo
贺	sdo
雾	ths
龄	ljk
椅	emz
挤	uqq
扣	udk
届	cdy
券	hhpd
熊	kvv
尝	sb
询	sno
喷	dnl
娇	btmp
夹	hhb
肥	vmb
祝	fdp
吾	wdk
寄	wmz
疼	ahw
斜	jxj
拟	uvj
迁	luc
钻	zyd
浑	kwy
肚	vgt
艰	rig
牢	wqn
惧	hqh
挡	uybj
敲	ghp
庞	xtl
叛	hux
鸣	dxn
柏	eub
薛	ltk
屈	csm
叙	jxr
悟	hwd
坡	grp
辽	ruc
腐	xjkj
匹	npe
铜	zmf
籍	ral
穆	xuye
割	wadp
旨	vor
擦	uwhf
沟	knk
抖	ujd
掠	ugy
奈	mfs
泉	uks
狱	msmq
揭	uon
晃	omg
怔	hfsi
猎	mlo
诱	sxv
娜	bau
猫	mlq
醉	yz
祭	hfs
貌	mup
池	key
琴	nnj
寂	wyf
遥	yau
瓶	hlr
羽	zv
昆	ovv
辉	mwy
吞	fmd
牲	qls
哀	tdk
昌	oor
厌	xmq
晶	ooo
剂	qpd
绩	iao
筹	rak
柱	ein
搬	uir
莲	lyu
鹰	xjux
鞋	tgg
俊	jkh
恼	hzb
瞪	qhz
俱	jqh
稿	xgg
搭	ulj
僧	jhr
纠	iij
亏	mae
睁	qxb
弥	bx
弥	bxy
践	pfp
猪	mqo
迈	fpu
瘦	apgr
浅	kfp
挣	uxb
逻	ylu
宿	wjf
疲	arp
邻	jkt
惑	pdfh
胖	vhu
丛	jjf
跪	pxx
傻	jtr
贾	vob
稀	xbnr
脏	vxg
慰	cfkh
廷	tgu
饰	qer
鉴	prz
贷	jpo
祥	fgy
葛	lon
冠	wmpk
跨	pmm
耗	avm
赔	oidk
悬	fkhx
仲	jdg
拦	uht
戈	pg
粒	pil
遣	cku
捉	upu
赢	fdv
拨	usr
傅	jnk
仆	jyb
锦	zur
趁	pje
贤	prob
贪	jao
澳	ktmm
削	yvp
衰	tdf
扔	uvn
卓	yon
湿	koc
瞬	qyw
桃	epw
鼠	ps
辖	ywad
遂	hju
闷	ahx
雕	mgdu
邮	dte
誉	khs
暖	oyf
阔	aka
乾	nona
祸	fdmj
押	usj
枚	ehp
梯	ehtf
豆	zd
歇	onfe
嫌	bhb
碗	mwl
涂	kjx
挖	uea
抑	ubz
烂	cht
契	apm
娃	bgg
循	wxn
渔	kwv
嘉	hsd
丑	agt
赋	ofps
斤	tj
勾	nks
寺	gkc
吼	dha
坛	gb
坛	gby
惟	hui
邀	ulhu
械	epl
滴	kim
赴	py
赴	pyb
堪	gz
堪	gzh
帽	ro
帽	roq
帅	prj
逊	hyu
傲	jap
吨	dfs
仓	jzj
浩	kqd
寸	kc
姿	web
覆	vwe
闯	anm
愚	qvh
痕	aig
牺	qvx
瑟	nnht
唤	dx
唤	dxm
赌	oqo
庙	xdy
蔡	lhfs
扁	mic
哩	ddl
煤	cze
玻	nrp
汪	knw
苗	lqt
峡	vhhb
敦	ghh
逆	hsu
纹	ivw
宅	wtr
妥	ybn
忌	vhx
郁	nvt
笼	rtl
盐	gya
玲	njk
唇	fdk
耀	mzu
慎	hnq
秩	xth
涨	kbp
墓	lomg
饿	qtu
陵	tgh
羞	gag
恒	hfo
纽	iag
弓	bg
糖	px
锐	zhd
缝	iha
夸	mma
喘	dvl
喘	dv
碧	num
卧	qy
卧	qyb
宏	wnk
岗	vmbi
惩	wfsh
谨	sld
疏	tbo
斥	tid
滋	khi
串	ddg
漠	klo
屏	chl
悔	hek
溜	kbq
挨	uko
档	ey
雇	mui
扇	mzv
蛮	zcc
鸿	kux
歼	glq
砍	meq
欠	eq
糟	pfy
添	kfm
柴	sve
屠	cqo
勉	wps
肌	voj
齿	lc
赐	oon
桂	eggt
刷	crp
聊	qb
肝	ve
肝	veg
捷	ufb
喂	dqf
喂	dq
舱	ijz
啥	dja
唉	dko
磁	mhi
茫	lkf
嫁	bwj
乙	ai
嘿	dph
瓜	yg
丘	tfi
菌	lrx
粹	pzjn
催	jvu
吩	dhp
披	urp
履	cwe
乳	yha
煞	xbhc
廉	xhbc
兹	hii
儒	jtl
扯	usi
狐	my
狐	myg
姊	btf
缠	ixd
伐	jpg
矮	oxb
姜	gbn
绘	ijb
卿	big
斩	ytj
穴	ex
肤	vhf
陛	tvv
鹏	vvx
肿	vdg
肿	vd
辅	ynf
肖	yvy
沃	ktm
巫	ujj
罩	yyo
柄	efm
缴	iul
潘	ktp
蜂	chaf
窝	ed
窝	edm
舌	as
晴	oav
弘	bks
隶	bks
悠	jghh
耕	aqj
郡	btdt
爵	yyik
奸	beg
绳	idm
辨	npn
溃	kco
婴	oob
孝	qhi
怖	hnr
丫	hgs
愁	xchx
亭	gad
携	uuv
泄	kla
疫	ars
谭	svon
翠	zzj
霞	tcm
惹	lndh
酷	yqd
癌	add
翰	nonz
昂	obz
劈	cdnp
甜	azg
棉	eur
剥	bkp
卑	utn
矣	kos
袍	tnv
轨	ykj
卜	ybb
柯	ez
柯	ezk
吟	djae
鞭	tjf
宰	wnx
脖	vnw
俘	jyh
辱	fkc
尿	ck
尿	cks
莉	lxp
咽	drm
臭	omq
吻	dne
疆	bgf
饱	qnv
抹	ufe
愣	hyl
凑	wai
芬	lhp
朕	vhm
畏	qft
骤	nqr
禅	fhq
拾	uj
炉	cm
炉	cmh
渴	kon
铃	zjk
妨	blf
填	gnq
豫	iwx
劣	yts
竭	ion
愉	hjv
摔	uzi
览	pre
顽	mpw
脆	vxx
吵	dyt
泡	knv
毅	ijr
吊	drj
扮	uhp
狄	mch
腔	veu
遮	xlcu
鹿	xl
肠	vae
肠	va
灌	kld
夕	lx
址	gsi
壳	gwo
氧	vgy
屁	cvv
饶	qpf
狭	mhh
摘	uim
芒	lfw
棋	ezh
讼	shk
杆	eeg
翁	hkz
倘	jss
胃	qvy
拆	uti
盒	jda
驰	ney
鲍	wnv
纲	imb
璃	nz
璃	nzb
艳	axm
匪	nrf
蓄	lzi
妄	fbn
姚	bpw
漏	kct
秒	xyt
柜	enn
掏	una
函	akmk
哎	dlb
於	ljw
裤	txy
猴	mjn
枯	ecg
喉	djn
悦	hhd
痴	aod
畜	ziq
衫	tes
寨	wqhe
誓	uts
翅	cz
翅	czv
膀	viw
钦	zeq
纤	ilq
厨	xzk
撑	usu
宴	wob
锅	zdm
涛	kak
淮	kui
盈	vra
胎	vkd
崩	vvv
拐	uds
轩	yeg
茨	lweq
盆	hpa
崖	vxgg
砸	mnr
刹	bep
姬	bqc
晕	owy
赚	ohb
囊	ndw
凄	wfb
膜	vlom
葬	lgv
挽	uwp
耸	jjq
脾	vut
诞	sts
懒	hxx
妃	bvj
斑	nvn
崔	vui
後	wih
嫂	bpg
颠	nqh
棵	eqe
佐	jnu
尉	cfk
陡	tpz
眨	qtr
陀	twv
陕	thh
蜜	whtc
饲	qaf
肺	vfr
颈	ruw
眠	qdm
喃	dnm
撕	uzh
驳	nbb
摊	urui
朴	eyb
拘	ugj
酬	yoo
塑	hsvg
爪	ya
寇	wmph
岭	vjks
裕	thg
僵	jfq
卵	bl
盼	qhpd
赠	ohr
狮	mpf
逝	utu
藤	lvh
湘	keq
棍	eov
堵	gqo
歪	cfs
窃	erp
冻	wry
俯	jxjk
虹	cug
陌	tfu
骄	ntm
甫	nff
盲	fqm
姻	brm
畅	oga
拓	ums
啸	dbp
抄	uyt
昭	opdk
猩	mol
拱	ulh
摧	uvu
菩	lid
蓬	lha
铭	zld
浙	kut
洒	kvx
氛	vhp
饥	qoj
踢	po
踢	pon
璇	nle
泊	kub
琼	ngy
锡	zon
滩	krui
捧	uai
讶	sly
咳	dkh
嘱	dct
绵	iur
筒	rmf
冈	mbi
萍	lke
挪	uau
辟	cdn
钩	znk
歧	sci
芝	lri
谅	sgyx
逢	hau
鼎	qaa
廊	xii
吁	dfn
栏	eht
巾	rj
罕	whe
链	zyu
溪	kyi
趟	pss
坑	gzo
躯	znb
吏	fdb
歉	hbce
沾	kyd
妮	bcvb
筋	rvs
殷	zrs
棒	eaiu
坠	tjg
渊	kpp
匠	ntj
耍	lb
葡	lnn
寡	wwp
捏	uog
鸭	sx
冤	wwt
钉	zad
舟	io
瞎	qw
笨	ref
辰	fc
瞒	qlm
剪	hvp
耻	qsi
漆	kej
阎	axp
骇	nkh
擅	uzr
孕	vhi
诡	sxx
莎	lky
昔	lor
蠢	aioc
宠	wtl
茅	lit
谦	shb
淋	kee
账	opc
胶	vab
玑	noj
胀	vpc
庸	xbt
衙	pwd
乞	eai
媚	bcq
膝	vejk
逮	bku
宛	wlz
翔	gzv
夷	mbg
骚	nri
荆	lfl
杭	ezo
裸	tqem
乖	lav
姨	bmb
哑	dfc
嚷	dtd
旺	onw
叉	rid
恍	hmg
惶	hun
咒	ddo
镖	zvf
亨	grl
窜	edd
杖	efb
蝶	clae
逸	wuc
恕	bdh
搏	unk
焰	cx
绣	ixv
禧	fhd
淫	kytg
丐	fya
碑	mut
鹅	tup
蒲	lknf
阐	ahq
轿	ytm
伞	jhn
蔽	lfh
咐	djk
兆	pww
爽	mbbb
豹	mni
弦	bzi
薪	lie
冥	woa
捐	udv
谎	slfo
愧	hag
衷	tdg
倏	jghm
猿	mgdt
哇	dgg
粘	pyd
栽	npem
浦	knf
掀	ute
脂	vvo
嘲	dno
框	ennw
矩	onn
龟	wgg
叠	rrr
谊	swf
脊	wwj
刮	apd
兔	wtt
哨	dyv
娶	qrb
聘	qdf
慨	hid
俺	jmo
嗓	drr
舅	pqs
寓	wqv
戚	nyf
戚	ny
仑	jl
恳	ihx
瘤	abq
掘	ucs
浴	khg
倡	joo
裹	tq
圳	goc
渠	knn
钓	zni
涵	kakm
泼	ksr
瓷	wer
祈	ft
窄	ewa
拂	utf
巢	oqe
贞	yob
纱	iyt
绑	iat
茂	lnu
砖	mmai
谱	shc
坟	gvw
噢	dtmm
硕	mw
侄	jyi
蹲	phy
甩	tae
匈	nbm
胳	vsg
躬	zbg
徽	wvfh
邵	pdt
蜀	ync
篮	rpr
竖	pri
颁	hpw
焉	fsf
壶	gwc
浸	kbw
萄	lna
僚	jmh
玫	nhp
桓	efof
攀	ebb
撰	uvvh
旬	nor
媳	boh
嘻	dhd
蒸	lak
裙	tbt
滥	kpr
愕	hdd
讽	sobi
霜	teq
诏	spd
躁	pdd
厘	xdl
憾	hnf
帘	erj
巷	lhv
溶	kwhg
勋	dos
亩	zqt
晰	oet
滞	klwr
舆	pyh
咸	nfd
衔	pzj
邱	tft
挫	ujjg
搁	uasg
桩	exg
雀	yui
辣	nxs
诧	swt
哗	djvn
屡	cpb
喻	djv
窑	eaf
踩	pye
鸦	lxn
郊	abt
株	eta
秃	xoj
禄	fbk
厦	xfo
卒	zjj
丸	kid
聂	qrr
雁	xju
琳	nee
虏	zsl
汝	kbn
肢	vc
咕	dcg
耽	qwp
咖	dsd
煌	cun
肆	pbv
哄	dlh
弊	fhl
耿	qch
叮	dad
倦	jhh
腺	vuk
彪	zes
鹤	wux
尴	opr
巩	uoi
焚	eec
饼	qhl
鄙	dnrt
拢	utl
瞄	qlq
勿	nes
菊	lnp
厢	xeqm
腕	vwl
斋	vle
诈	swa
呜	dxu
怯	hgk
铸	zak
诀	snj
绢	idv
魄	uag
婉	bwl
兜	ubn
涅	kog
禀	zrdf
驴	nmh
垄	tgt
擒	ujzv
囚	rjr
捞	ulw
舶	iub
倚	jmz
喀	dws
贱	ofp
稣	wxh
冀	avq
厄	xzj
溢	kka
炭	vnc
稽	xov
渗	kkm
泣	kil
罐	ald
螺	cqi
衍	pks
狡	mab
桶	ekt
塌	goz
卸	azj
嘶	dzht
帆	roi
侨	jtm
逗	zuc
昧	oaw
蓦	lomn
坎	geq
棺	ewk
荐	lng
雌	svu
棚	evv
靖	iav
裴	rti
栖	evx
钧	znw
贩	oxr
啡	drf
衬	tkc
兑	hdp
榜	eiw
魁	ajd
谜	spu
毙	vvg
麽	ztk
瞥	fhqm
纺	ilf
掷	uhm
肾	prv
烛	ccc
谬	szj
锻	zuf
芦	lmh
膨	vhe
珊	nic
刃	pid
隙	tyo
垒	kkkg
嫩	bxh
钥	zvy
塘	gxb
韵	xnw
旱	oeg
咨	wed
喇	dxp
驼	nwv
颂	hkw
譬	cdns
尹	btp
傍	jiw
坊	glf
哟	din
忖	hkc
霉	tek
苹	leh
佣	jty
搂	upb
堤	got
怡	hkd
淘	kna
谍	sla
藩	lkt
贬	otr
斧	hbt
糕	pgc
俞	jvp
颖	vxw
砰	meh
稻	xyp
熙	qvc
盏	fpa
棠	sem
黯	pxy
襄	tdd
烤	cqf
詹	xxhs
煮	qoc
魅	aaw
蕴	lio
谐	svv
谕	sjvp
骆	nsg
捆	ure
剿	oqep
枕	ewp
轴	ydy
笛	rdy
挟	uhh
逾	jvpu
咧	dgp
斌	vfps
捡	ujk
壤	gtd
黛	jpp
沼	kpd
辐	yfd
娱	bdf
淑	kyf
淹	kmo
窦	ena
呐	dmj
灿	cvs
迦	sdu
绅	iog
禽	jzb
犬	mq
倩	jav
彦	ixe
伽	jsd
蹄	piw
枢	enb
啪	duu
妾	ibn
搅	ukw
汁	kns
凛	wz
羡	gwe
伺	jaf
蚁	cib
剖	idpd
幢	ridl
绞	iab
瞅	qxc
俏	jyv
娟	bdv
奢	mqor
膊	vnk
谴	sck
丙	fmj
滨	kwth
窥	ehe
斐	rvw
祷	fak
藉	lalo
敞	shp
厮	xzht
凰	oun
咯	dsg
顷	vwy
沸	ktf
绸	img
椎	eui
莹	lwn
垫	ukig
廖	xzje
捣	uxv
叩	dzj
蜡	clo
侮	jek
眸	qkq
眸	qk
逛	mnu
芙	lhf
炒	cyt
谣	sya
沫	kfe
咋	dw
屯	fsc
屑	cyv
瑰	nag
峻	vkhh
喧	dwf
晒	ovx
莽	lml
矢	os
熬	aphc
龚	tlh
撇	ufh
梳	ebo
醇	ygh
辜	cnx
迄	eau
匙	otv
嫉	bao
睹	qqo
镑	ziw
诵	skt
嗅	dom
痒	agy
栗	vem
颊	hhw
缅	ibm
缚	ink
樱	eoo
妒	bmh
麟	xpl
逍	yvu
潭	kvo
芯	lhx
郝	gct
蛛	cta
凳	hzo
堕	tnvg
揉	uit
婢	but
梭	ekhh
嗣	dia
虞	zdf
垃	gil
妓	bci
勘	zhas
篷	rha
乍	wa
桐	emf
缕	ipb
叱	dvb
鲸	wgyx
贿	onv
趴	phb
朽	efa
硅	mgg
奎	mggt
钞	zyt
磕	mgka
瑶	nya
隋	tnu
憎	hhr
蔑	lyn
馨	gcr
杏	edk
栋	ery
昼	cio
苟	lgj
腥	vol
萝	lyl
弩	brb
碌	mbk
寝	wab
倭	jxb
垮	gmma
岚	vobi
燥	cdd
姥	bql
沦	kjl
兀	fpe
铅	zod
砂	myt
兮	hfa
牟	kqn
哉	npd
浆	alks
虐	zbj
嗡	dhk
旷	oxg
沮	kfq
帖	ryd
诛	sta
鳞	wpl
涯	kxg
遁	xnqu
澄	khz
锤	zll
滔	kyp
寞	wlo
妆	abn
蹦	pvv
阮	tmpe
募	loms
敷	nlh
眯	qpm
汹	kbmk
嘟	dqot
霆	ttg
褐	ton
畴	qak
蚕	fmc
嚼	dyy
奠	hym
榴	ebq
拙	usm
蚀	qcc
荫	ltv
鸽	jdx
咦	dmbg
甸	nqt
吱	dci
泌	kht
暮	lomo
挠	upf
叭	dhb
灶	cgt
峨	vtu
蓉	lwh
菱	lghh
稚	xui
澡	kdd
蔓	loy
泻	kwf
裘	fkit
溅	kof
丞	akf
秉	xbj
绒	ipn
遏	onfu
彬	eees
熄	coh
朦	vlw
琢	nji
膏	gvy
泳	kik
凿	cgm
敛	jkfh
庐	xmh
惭	hyt
畔	qhu
沧	kjz
酿	yii
阀	ajp
虔	zvw
侣	jdd
匀	nwb
拯	uak
莺	lwx
屿	vfa
沪	kmh
叟	pgr
藻	lkde
雍	ziu
瘫	arui
蹈	pyp
揽	upr
氢	vru
豁	wadh
骸	fkh
陋	tfm
捂	uwd
冶	wkd
懈	hxt
坪	geh
蔬	ltb
翘	pfpz
嘎	dfop
缔	iiw
钮	zag
娥	btu
讥	soj
晤	owd
灼	cni
舵	iwv
纬	igw
圾	gcj
澜	kax
茎	lru
鄂	ddmt
歹	gd
邹	xbte
枉	enw
琉	nbo
庇	xvv
杉	ees
跋	pnr
梢	eyv
戳	zup
蝉	chq
毯	vcc
萎	lxb
裳	sti
绰	iyo
佑	jnd
狸	mdl
拚	ukl
窟	ecs
硫	mbo
腻	vpmo
憋	fhh
凹	mfi
赎	ona
崎	vmz
烁	cby
嚣	ddw
焕	cxm
暑	oqor
扛	uug
匕	vb
揣	uvl
凸	vfi
怠	kdh
觅	yej
呕	dnb
孽	ltkh
楞	eyl
矫	otmp
潇	klb
簇	rle
簇	rl
浇	kpf
枣	emw
绥	iyb
芽	lly
蝇	cdm
僻	jcd
榻	eoz
宦	wqc
沐	kem
毋	kuu
碟	mla
仕	jgs
戎	pns
呻	dog
啼	diw
虾	cfy
樊	ebbm
棕	ewf
萌	lov
嫣	bfs
伶	jjks
鞘	tyv
删	ipd
嵌	vze
暇	ocm
蛟	cab
茵	lrm
驯	noc
炕	czo
碳	mvn
烫	kaec
咚	dhw
苑	llz
蚂	cnm
厥	xhs
雯	tvw
赦	gchp
慷	hxb
旭	kor
煎	hvpc
惕	hon
颓	xow
坝	gob
悍	hoe
匿	nln
噪	ddde
涡	kdmj
禹	tdv
敝	fhp
缸	aug
簿	rkn
坤	gog
琐	nyo
蚊	cvw
粟	vpm
诫	spl
髓	fnuu
梵	eeo
溯	khsv
蝴	ccv
尬	ojp
涩	kpi
揪	uxc
窘	ebt
棘	eme
盔	nca
喔	dcy
婶	bwo
踱	pxl
嗜	dqo
啤	dut
哺	dnf
奕	zcm
淳	kgh
镶	ztd
晌	otm
粪	plh
铲	zix
瑜	njv
冢	wji
唾	dllg
庵	xmo
扼	uxz
聋	tqe
庚	xbjr
膛	vsgt
疤	amb
叨	dpd
佟	jhw
绷	ivv
棱	egh
慑	hqr
筷	rhn
庶	xlc
沁	khx
渺	kqy
迂	fnu
梨	xpem
拣	ury
葫	lcv
浏	kvp
橡	ewx
扳	uxr
嘘	dzc
牡	qgt
贮	owf
窍	euf
襟	teef
眷	hhqm
弧	byg
癫	anq
葱	lne
熏	lph
噗	dcgi
炯	cmd
稼	xwj
稼	xw
鞠	tnp
朔	hsv
栅	eic
霎	tib
匣	nsj
厕	xop
眩	qzi
眩	qz
岔	hpv
缆	ipr
谏	sxh
呃	dxz
唔	dwd
懿	gwzh
斟	zhaj
拧	uwa
嗤	dsf
磅	miw
尧	pfpe
鳍	wqo
肘	vkc
帜	rdh
晦	oek
搓	ugu
粥	bpb
枫	eob
琪	nzhb
裔	tmh
彰	xne
瞻	qxx
邑	dmb
吭	dzo
垣	gfof
嗽	dxe
皓	uqd
竿	reg
嚎	dgj
拽	uoa
倪	jppe
胧	vt
胧	vtl
峭	vyv
攸	jghp
瓣	nyn
忿	hph
扒	uhb
嘀	dim
桨	ale
锥	zui
梗	efo
蹬	phz
夭	tmd
俭	jjk
淌	kss
廓	xgh
浊	kcc
碱	mnf
迭	thu
讳	sgw
逞	dnu
邸	bit
檀	ezrf
磷	mpl
撼	unfh
踉	piig
娅	bfcy
绽	iwt
哆	dll
诬	suj
靴	tjv
冉	mgt
芸	lby
奚	yim
宵	wyv
戟	nonp
札	eae
蛙	cgg
擎	lghu
沛	kfr
硝	myv
崛	vcs
槽	efy
喽	dpb
礁	muc
哮	dqh
腮	vqhx
蜘	cod
妞	bagt
刁	afi
栓	ejn
熔	cwh
懊	htm
铮	zxb
侥	jpf
炽	cdh
鞑	tmu
胚	vcf
苛	lzk
迸	hlu
敖	aph
轼	ypu
轼	yp
祁	fte
拇	ukm
窒	eyi
邢	flt
酌	yni
柬	xhb
悼	hyo
瑛	nlm
颐	qwy
掐	uxp
猝	mzjn
缀	irr
锣	zyl
饷	qtm
卦	ggyb
壕	ggj
噬	dru
絮	bdi
崭	vyt
馈	qco
霄	tyvy
荀	lno
岑	vja
褚	tqo
墅	digt
墟	gzc
殆	gkd
涕	khtf
骏	nkhh
矗	nqff
徘	wrf
幡	rtp
釉	tpdy
嗔	dnq
煽	cmz
醋	ylo
匡	nnw
鞍	twb
袜	tfe
寥	wzj
槐	eag
罡	yfs
茜	lvx
挚	ukiu
缎	iuf
薇	lwv
闺	agg
湛	kzha
悯	hav
咆	dnv
毓	ekb
摹	lomu
颅	ycw
陇	ttl
唬	dzh
钙	zfy
缪	izj
酱	aly
痰	acc
锯	zccg
炫	czi
霹	tcd
杠	eug
忒	phx
懦	htl
笃	rnm
翩	miz
檐	exxs
婿	btv
搀	uwpw
肋	vsl
垦	igt
汰	kmi
捅	ukt
蟹	xtp
箫	rbp
箫	rb
拴	ujn
羌	gae
绊	ihu
嗦	dnwi
洽	kjd
瀑	kol
珀	nub
绎	iru
恃	hgkc
驿	nru
蟒	clml
撩	umhy
掳	uzs
抒	uiv
犀	ckq
芭	lmb
舷	izi
甄	vgr
拎	ujks
橱	exz
睦	qgh
臀	clhv
嫦	bsr
娴	bae
粤	trpa
蕊	lhhh
辫	ninx
酋	hyy
狞	mwa
诅	sfq
踌	pak
坞	gxu
渣	keo
亥	kh
巍	vxba
靡	zrf
瘟	aoa
瞿	qqu
惫	hqhx
陨	tdo
脯	vnf
骷	fcg
肪	vlf
祀	fvs
祠	faf
揖	udq
剔	onep
膳	vgh
叽	doj
钝	zfs
缉	idq
狙	mfq
靶	tmb
徊	wrd
氯	vbk
疮	ajz
蔚	lcf
鹃	dvxn
啃	dsvy
皂	urq
阙	ahs
鲤	wdl
峙	vgk
氨	vwb
禺	qvr
舔	afmh
骡	nqi
闽	ac
秽	xvl
闵	avw
咙	dtl
瑚	ncv
嬉	bhd
拭	upug
肮	vzo
佬	jql
紊	vis
狩	mwk
咎	hyd
栈	efp
嗨	dke
殉	gno
幌	rom
苔	lkd
嵩	vgg
篱	rzb
篱	rz
剃	htp
氓	fdm
婷	bga
昊	ofm
砌	mrp
绫	igh
佯	jgy
巳	vss
悖	hnw
炳	cfm
呛	djz
濒	kssw
屎	cpm
汀	kad
瞟	qvf
孜	hhp
嵋	vcq
犁	xpq
揍	uaim
苇	lgw
掺	ukme
趾	psi
酶	yek
榆	ejv
霖	tee
韧	gpi
拷	uqf
侈	jll
肇	mhb
饵	qqe
舜	ywl
兢	cpc
臻	yai
擂	utq
猾	mfg
恤	hta
隘	tka
忏	hlq
蝗	cunw
颔	jadw
绮	imz
琦	nmzk
诩	szv
钗	zri
茄	lsd
敕	xhp
睿	ghq
噜	dwo
跺	poe
佃	jqt
戮	zje
颉	gdw
铀	zdy
倔	jcs
蕉	luch
褂	tggy
溺	kbww
谟	slo
皖	uwm
狈	mob
噩	ndd
糙	pqd
瘾	atx
赁	jtgo
埔	gnf
咄	dsm
畸	qmz
赣	xnh
樵	euc
亢	zoj
侃	jdo
嫡	bim
眶	qnn
涤	khe
捻	uja
鸠	kxn
捍	uoe
芜	ldu
酥	yxh
屉	cla
眺	qpw
抿	udm
辙	ybv
胤	piv
闸	asj
蛊	cam
褪	tiu
鳌	aphw
彷	wlf
翎	jkz
婪	eeb
衅	tah
猖	moo
捶	ull
伎	jci
梧	ewd
洼	kgg
吆	diy
椒	eyf
瞳	qid
勺	nid
卉	nlc
竺	rme
嗖	dpg
淀	kwt
烘	clh
痪	axmm
炊	ce
炊	ceq
枭	xem
髦	pev
轧	yae
矶	moj
钳	zzg
稠	xmg
戊	nuu
羁	ytn
璋	nxn
咪	dpm
甭	cty
颌	jdw
铝	zdd
谒	son
麾	zvm
驭	nry
俨	jfc
侬	jwt
疚	axi
憔	huc
晏	owb
驮	nmd
烙	csg
赃	oxgt
怅	hpc
搔	uri
磋	mgu
篡	rqm
蹙	nyfp
毗	qvv
瞩	qct
笠	ril
殴	nbr
唠	dlw
喳	deo
锄	zfsl
隧	thj
剌	xpd
憨	aqhh
菁	lavy
狰	mxb
桔	egd
孵	byh
蝠	cfd
袅	xti
滇	knq
疹	aje
黝	pis
汴	kzy
缰	ifq
酝	yby
垢	gxf
掣	qrpu
琅	nii
嘈	dfyo
筛	rpf
谤	siw
曙	oyq
蕾	ltq
漱	kxe
阱	tqj
琵	nnv
胰	vmbg
狒	mtf
哽	dfo
呸	dcf
廿	ln
睫	qfb
蠕	ctl
吠	dmq
筐	rnn
讪	svs
惺	hol
汲	kcj
赂	osg
酣	yzg
澈	kbvh
滤	kzh
徙	wssi
抡	ujl
惋	hwl
漩	klet
孰	ghki
睬	qye
哧	dgc
椭	etn
钵	zef
笈	rcj
茹	lbd
褒	tjd
蛾	ctu
啧	dao
衲	tmj
毡	vyd
澎	khes
窖	eqd
曳	oat
荧	lwc
吝	vdk
跄	pjz
谛	siwr
淆	kbnv
菇	lbc
诣	svo
锈	zxv
辗	ycl
穗	xnqh
惰	hnu
鲨	kytw
柿	ezr
脓	vwti
巅	vnq
啄	dji
娄	pbn
帷	rui
簧	rnh
琛	nwh
萤	lwcc
奄	moa
盎	mmam
渭	kqv
馒	qoy
攘	utdf
鸾	zcx
忡	hdg
嫖	bvf
蝎	con
虬	cae
鹦	oobx
桅	exx
贻	okd
咀	dfq
鞅	tmm
翟	zui
惚	hne
拈	uyd
钊	zp
钊	zpd
攒	uqp
沌	kfs
痊	ajn
髯	pem
烹	grc
豚	vjs
咏	dik
腑	vxj
诘	sgd
渎	knam
悚	hxs
撮	uoq
磊	mmm
觑	zce
寅	wfdh
茸	lqe
忱	hwp
傀	jag
亵	tuk
匾	nmic
弛	bey
疙	aea
雏	xbu
弼	bfu
戍	nid
帛	urj
缭	imh
羹	gcgm
袄	ttm
迥	mdu
俟	jko
躇	plq
墩	gghh
鸥	nbx
痉	aru
抨	ueh
阜	tkn
禾	xhh
曝	ool
乒	tftp
壬	tgs
伢	jly
孚	yhi
隅	tqv
堑	ytg
恪	hsg
槛	epr
薯	lyq
驹	ngj
惦	hxy
怦	heh
炙	vch
恺	hvv
蒜	lff
坍	gmz
铠	zvv
韶	xpdk
咔	dyf
璧	cdni
驸	njkc
霓	tppe
嗒	dlj
彝	bpi
淤	klj
抉	unj
挛	zcus
捎	uyv
呱	dyg
袱	tjm
惘	hmh
蹑	pqrr
糜	zpm
蹿	ped
桀	lve
聆	qjk
褥	tfk
阑	axh
貂	mpdk
梓	enx
蹭	phr
俾	jut
漪	kmmz
矜	itj
圭	ggt
漓	kzb
穹	ebg
诃	szk
诽	srf
肛	vug
蔼	lso
蕃	ltp
鬓	pew
辄	yqa
恻	hop
阉	amo
崽	vqh
刨	nvp
瓢	vfy
祟	smf
幔	roy
沽	kcg
笋	rbt
筝	rxb
滕	vhhk
炬	cnn
葵	lhfm
铎	zru
恬	has
楷	evvu
袒	tof
冕	owpe
纶	ijl
疡	aaes
埠	gtk
偌	jln
蜈	cdf
橙	ehz
涧	kaor
煸	cmi
瓒	nqp
蝙	cmic
诲	sek
殃	gmm
痹	aql
晖	owyc
蜷	chh
鸳	lzx
噶	dlo
蘑	lzm
鹊	lox
碾	mcl
珂	nzk
芮	lmj
茧	lcc
羔	gch
靳	ttj
堰	gnob
悻	hgg
曦	ogx
黏	xjkd
橄	eaq
偕	jvv
妩	bdu
腋	vzj
暧	oyw
涟	kyu
拗	uis
憧	hidl
胥	tvy
芹	ltj
俸	jaiu
圃	rnf
薰	llp
秧	xmmd
拌	uhu
邯	zte
悸	hxh
锚	zlqt
瑙	not
砾	mby
癸	hfm
磐	irm
凋	wmg
溥	knkc
嬴	fdvi
亟	rdr
偎	jqf
橘	eit
滢	klwi
懵	hly
绚	ino
唆	dkhh
胺	vwbn
嚓	dwh
撬	uvvv
肴	bnv
纂	rqmi
碉	mmg
蹊	pyi
忐	yfh
楠	enmg
钠	zmj
笺	rfp
渲	kwff
娼	boo
湄	kcq
暨	idof
翡	rzv
鳄	wdda
萃	lzj
枷	esd
籽	phi
骼	fsg
韬	gyp
潼	kidl
祺	fzh
祺	fz
笙	rls
岐	vci
悴	hzj
攥	urqi
喋	dlae
蜕	chd
聿	bvv
氮	vcch
踹	pvl
釜	hbzj
叼	daf
揩	uvvu
麓	eex
嫔	bwt
劾	ksl
辎	yoq
翌	zil
乓	tfid
绯	irf
渤	knws
俐	jxp
粱	kphp
腓	vrf
撵	uhhy
搐	uziq
茬	lngg
赘	apho
龋	ltd
瘪	aoj
遽	zju
饺	qab
怂	jjh
屹	vea
沥	kxs
辕	ygd
缜	inq
睾	tyg
讷	smj
蚤	ric
锭	zwt
锭	zw
榨	eew
瑾	nld
蛤	cjdk
攫	uqqr
捋	uyk
骥	nav
瓮	hkr
汾	khp
惴	hvl
溉	kidu
妊	btg
惮	hhq
锌	znx
馀	qjx
帧	ryo
撂	uqs
酵	yqh
哒	dmu
绛	ihv
冗	woj
磺	mnh
赈	ofc
瀚	knoz
跤	pab
彗	aabj
顼	nwy
簸	rzhr
雳	txs
愫	hais
镰	zxh
掂	uxyd
擘	cdnu
谚	six
卤	yrb
箍	runr
跛	prp
筵	rts
膺	xjuv
桢	eyo
皈	uxry
渝	kjv
漾	kgi
铢	zta
啜	drrr
耆	qor
锵	zal
扈	mdm
瘩	alj
阪	txr
萦	lwi
囱	trh
暄	owff
哝	dwti
漳	kxns
藐	lmu
侏	jta
栩	ezv
吮	dkp
莞	lwm
砚	mej
匮	nco
涣	kxm
潦	kmhy
踞	pcc
秤	xeh
浚	kkh
惬	hnh
濮	kjc
瘸	asdj
琶	nnmb
癖	acdn
祗	fbid
邺	cte
杞	evj
瞠	qsgt
螂	cii
烽	cha
讹	sjv
臆	vxh
蜒	cts
蜿	cwl
沂	ktj
蹂	pit
颍	vkw
娠	bfc
帚	bwr
摒	uchl
蟾	cxx
遐	cmn
蜗	cdmj
螭	czb
淄	koq
萼	ldda
馅	qxp
苞	lnv
诠	sjn
谑	szb
氖	vvn
唧	diz
笆	rmb
蚩	sfc
谥	ska
燎	cmhy
掖	uzj
壑	ghrg
寰	wyft
馋	qwpw
黔	pja
竣	ikh
蹋	poz
骁	npf
榄	epre
豢	hhj
婵	bhqn
姗	bic
玺	xyn
饬	qes
鹉	fpsx
偃	jnob
唰	dcr
涎	ktsu
呗	dob
麒	xzh
跷	ppf
嗷	dap
丕	cfi
鼾	oqle
阖	agka
撅	uxh
渍	kao
僭	jddo
臧	nqc
炖	cfsc
噎	dgw
筱	rjg
缤	iwth
烬	cci
瑕	ncm
卯	bmm
酪	ysg
簌	rxe
漉	kxl
戌	nfi
汶	kvw
轲	yzk
汛	kans
峦	zcv
褶	tzu
铐	zqf
盅	dga
胭	vrm
踵	pld
晾	ogyx
苯	lef
恙	ghx
飒	iob
镯	zyn
藕	laq
筏	rjp
萱	lwff
奂	xmm
芥	ljp
叁	kmt
憬	hog
媛	byf
碘	mihb
嗳	dyw
彤	mze
邙	fte
兖	akp
酉	yy
茗	lldk
沓	kor
嗟	dgu
闾	addk
挝	uku
癞	axx
坯	gcf
伫	jwf
雒	sui
鹫	gyo
荃	ljn
锺	zldl
挎	umm
铿	zpr
飙	mmmb
蟋	ctph
谧	sht
亘	fof
猥	mqf
惆	hmgd
刽	jbp
媲	btr
氟	vtf
湍	kvl
蔷	lghd
璐	nps
嗫	dqr
稷	xqh
稷	xq
缄	inf
垛	goe
瘢	air
蕙	lnqh
浒	kse
甥	lqsl
迳	ruu
迳	ruuc
睑	qjkf
甬	kty
逵	ghg
祯	fyob
鳖	fhw
汞	uks
恣	weh
诰	sqd
旌	lel
珑	ntl
梆	eat
捺	umf
斡	nonj
湮	kvg
螅	cohx
喏	dln
胯	vmma
蘸	lyuc
螃	ciwl
荔	lsss
蚌	caf
瀛	kfd
蟠	ctpq
踊	pkt
痔	agk
皿	amm
贰	pmo
隼	uns
芷	lsi
荼	ljx
傩	jru
徵	wvfh
泯	kdm
蓟	lwp
簪	rdd
骰	fr
骰	frs
脐	vqq
飓	obq
孺	htle
辘	yxl
佚	jth
羚	gjk
漕	kfy
腱	vbu
晁	opw
皋	umn
抠	unb
桦	ejvn
髅	fpb
楔	eap
谄	sxp
赡	oxx
唷	dbv
寐	waa
椰	eqt
蜻	cav
疣	aoy
嘭	dhe
蟀	czin
篓	rpb
崆	veug
泵	mks
蹒	plm
搪	uxbd
玷	nyd
卞	zyb
噼	dcd
镀	zxl
鑫	zzz
琏	nyu
娓	bcv
杳	eor
犊	qna
昙	oby
闰	anw
篆	rbj
踝	pqe
呷	dsj
熹	hdc
缨	ioo
蓓	ljid
璞	ncg
坂	gxr
钾	zsj
鹞	yax
剁	oep
谩	soy
瞑	qwo
佼	jab
噤	deef
戾	mmq
汕	kvs
赓	xbjo
馍	qlo
嗥	dum
煜	coi
谙	sxy
塾	ghkg
茉	lfe
髻	pegd
泗	kys
秸	xgd
袂	tnj
贲	nlo
湃	kuf
迢	pdu
哞	dkq
淞	keh
潞	kps
煦	ogc
婊	bat
耷	mqe
掰	uhpu
拄	uin
涸	krc
鳃	wqhx
盂	fna
傣	jaik
虱	atc
羲	gxfp
喙	dbj
欤	fafe
麝	xzkc
撸	uwo
徇	wno
匝	nrj
痞	acd
咂	dnr
豺	mnt
躏	pla
锷	zdda
夙	ogd
纣	ikc
瞌	qgka
窿	eth
诙	snc
喟	dqv
荪	lhy
匍	nnf
啬	ghrd
坷	gzk
殡	gwth
潺	kch
岌	vcj
缮	ighd
澹	kxx
蛰	ukic
嗬	dljz
斛	xtj
锏	zao
恫	hmf
蟆	clom
町	qad
骠	nvf
唏	dbn
绶	iyw
卅	lss
橹	ewo
钡	zob
淇	kzhb
胱	vmg
螳	csgt
皑	uvvj
谀	spj
鸯	mmx
跻	pqq
擞	upbh
椿	eaio
嘤	doob
篝	rqf
厩	xid
嵇	xovs
腆	vih
蛀	cinw
邬	xte
恚	gghx
夔	hos
辍	yrrr
咻	dje
涓	kdv
箓	rbk
轶	yth
跚	pic
邃	ehj
嚏	dnwt
曜	ozu
翱	umnz
珥	nqe
瞰	qaq
岱	jpv
臼	pjj
眈	qwpe
葆	ljd
猓	mqem
籁	rxx
苻	ljkc
谆	sgh
扉	mrf
槌	etk
箕	rzh
蔗	lxl
啾	dxc
腼	vbm
荤	lwy
剽	vfp
泾	krug
淖	kyo
酮	ymf
锢	zrc
雹	tnvs
骧	ntd
龛	jdt
恿	kthx
裆	tybj
獗	mxh
鹳	lddx
牒	ala
樟	exn
焙	cidk
痣	agh
檬	elw
疵	asv
熠	czu
睽	qhf
泞	kwa
蚯	ctf
蛹	ckt
畹	qwl
淬	kzjn
怆	hjz
罹	yhu
飕	obp
浣	kwm
桧	ejb
琥	nzh
銮	zcz
鋆	gnwz
啐	dzjn
宸	wfc
沣	kaf
睐	qah
翦	hvpz
颚	ddmw
沅	kmp
镐	zgg
斓	vax
璜	nnh
祛	fgk
娲	bdm
庖	xnv
咫	cidh
荟	ljb
僮	jidl
昵	ocv
皎	uab
氦	vkh
罔	mhf
闩	afi
槟	ewt
溟	kwoa
缥	ivf
楣	ecq
蛔	crd
靥	xmb
黜	psm
囔	dnd
骋	ndf
忻	htj
榈	ead
阂	akh
妍	bfl
橇	evvv
瘠	aww
灸	xic
噫	dxh
杵	een
镁	zgm
儡	jqqq
耘	aby
腌	vmo
觐	ldae
醮	yuc
焊	coe
醺	ylp
黠	pgd
侗	jmf
椋	egyx
舀	ypj
窠	eqem
裨	tut
摞	uqi
瘴	axns
癣	awgy
耙	amb
芍	lni
捱	uxgg
栾	zcem
榕	ewh
龈	lig
痘	azd
睢	qui
绾	iwk
擢	uzu
鬃	pewf
弈	zcl
獠	mmh
蛆	cfq
谗	swp
铛	zybj
倌	jwk
邝	xte
圪	gea
痫	aaem
啷	diit
邕	odm
酰	yqp
晔	ojv
渥	kcy
佗	jwv
睨	qpp
蜥	cet
孛	nwhi
郸	hqnt
镌	zuv
鳗	woyr
痢	axpd
冁	hqn
秆	xeg
嚅	dtle
胄	dvy
郅	yte
蝌	cxj
瘀	aljw
觊	vve
蚪	cjd
暹	ouu
锹	zxc
饴	qkd
穑	xghd
糯	ptl
哂	dvx
掸	uhq
蛐	cyq
岖	vnbi
蜓	ctg
疟	abj
蹩	fhpu
莓	lek
胛	vsj
谌	szh
岬	vsj
囤	rfs
嬷	bzt
糠	pxbk
汩	kor
酗	ybm
洵	knor
蚣	chk
氪	vcp
蜃	fcc
鳎	woz
孪	zchi
弑	bepu
棣	ebk
舐	abs
峪	vhg
疱	anv
炀	caes
箩	ryl
阚	aaq
龇	lsv
镂	zpb
咣	dmg
徨	wun
盹	qfs
袤	tit
郢	dnt
嗐	dwad
砥	mbid
荚	lhhb
蚓	cbg
偈	jon
氐	bid
咛	dwa
愠	hoa
鄱	tpqt
怏	hmm
淙	kwfs
琊	nlt
苓	ljks
馁	qybn
柠	ewad
涝	klw
鹄	qdx
濑	kxxo
胫	vrug
芋	lfn
璀	nvu
隽	uvn
弋	pi
燮	sccr
泓	kbk
窈	eis
畿	iip
衢	pqqu
鹭	psx
瑁	noq
碴	meo
筠	rgn
韭	rfi
涿	kji
龌	lcy
婀	btz
戛	fop
臊	vdd
宓	whtp
蟑	cxns
豌	zwl
骊	nfv
宕	wms
鲫	wiz
鲇	wyd
煊	cwf
罂	ooa
娩	bwp
铬	zsg
蒯	lvv
褴	tpra
谔	sdd
骈	nhl
洄	krd
镣	zmh
崂	vlws
箴	rnfd
妲	bof
檄	eul
沏	krpd
啵	dkr
汐	klx
疽	afq
纫	ipi
蒿	lgg
鹗	ddmx
俦	jak
殒	gdo
魇	xma
幺	iy
榭	ezkc
蓿	lwj
粼	plv
绺	ihy
圩	gfn
忑	fyh
琬	nwl
诋	sbi
迩	xyu
藓	lwg
靼	tofi
俚	jdl
殁	grs
饕	dfa
仄	xjr
牍	ana
蠡	bjc
蠡	bj
诳	smn
霭	tso
懋	eith
掬	unp
熵	cim
濂	kxh
锰	zham
婕	bfb
袈	sdt
镭	ztq
皙	etu
咝	dii
斫	mtj
褛	tpb
臃	vzi
娑	kytb
匐	nfdq
埂	gfo
柑	ezg
榷	ewu
歆	xeq
噙	djzv
犒	qgg
馐	qga
孢	hnv
蓑	ltdf
郦	fvvt
霾	tmdl
鸵	xwv
叵	ndk
氲	voa
鲲	wov
祚	fwa
鹑	ghxn
岷	vdm
滦	kzce
啮	dlc
纭	iby
恸	hbs
艮	ig
娉	bdfa
扪	uam
诿	sxb
滂	kiw
讫	sea
弁	klc
蛭	cyi
谡	sqh
砧	myd
莘	lnx
啻	iwrd
舫	ilf
荨	lbk
辇	hhy
雉	oui
俑	jkty
冽	wgp
椽	ebj
泸	kyc
钛	zmi
榔	eii
蕨	lxhe
诒	skd
覃	von
揆	uhfm
蟮	cgh
烯	cbn
翊	izv
獾	mld
姣	bab
憩	aoh
摈	uwt
缙	ifc
鲈	wycs
嘹	dmh
钚	zcb
孀	bte
洌	kgp
纾	iiv
饨	qfsc
剐	dmjp
浜	kthb
瘁	azjn
祐	fnd
缇	iot
怵	hei
烷	cwm
隍	tun
嶙	vpl
粲	grpm
沱	kwvb
篙	rgg
挞	umu
猕	mbx
蹶	pxh
摁	urm
赊	ojf
涮	kcr
铡	zop
噘	dxhe
刍	xbj
鹂	fvvx
牦	qvm
狻	mkh
鲑	wggt
耄	qvm
遛	bqu
垠	gig
蝮	ceo
坳	gis
妫	bis
樽	ehy
茁	lsm
呓	dla
奁	mnb
懔	hzr
箔	rku
钜	znn
濡	ktle
莒	ldd
阡	tlq
慵	hxbt
犄	qmzk
蚱	cwa
谘	swe
佞	jmb
铤	ztg
颧	lddw
熨	cfkc
纨	iki
剜	wlzp
殓	gjkf
槁	egg
邂	xtpu
骛	ith
唑	djj
庑	xdu
瞭	qmh
诤	sxbv
辏	yaim
祉	fsi
犟	bdc
猬	mqv
夯	msl
妪	bnb
胪	vyc
钰	znid
馕	qnd
恁	jtgh
荩	lciw
榘	onne
罄	gcra
谝	smi
仨	jts
僖	jhd
闱	agw
靓	ave
榛	eaix
簦	rhz
宥	wnvy
潢	knh
饯	qfp
涔	kvj
寮	wmh
忤	hen
泅	krj
隗	tag
墉	gxbt
胴	vmf
蝈	crn
砷	mog
珞	nsg
鳅	wxc
獭	mxx
荥	lwks
觥	xtm
鏖	xzj
嘁	dny
柚	edy
菠	lkr
倜	jmg
掇	urr
氤	vrmd
淅	ket
蛳	cpfr
酚	yhp
峒	vmfd
涞	kah
繇	yat
俅	jfk
嗑	dgk
烨	cjv
燔	ctp
邋	opu
咿	djbt
旖	lem
镍	zoem
霁	tqq
椤	eylx
蚜	cly
辔	iyi
鼐	vqa
咤	dwtr
峋	vno
拮	ugd
踮	pxyd
酯	yvo
壹	gwz
庋	xci
癜	acl
饽	qnw
搽	ulje
蛎	cxf
迨	kdu
偻	jpb
槊	hsve
谶	sjjf
赳	pij
龊	lpu
媾	bqf
馄	qov
啕	dna
嗵	dkt
墒	gim
恽	hwy
琰	ncch
铣	zqp
嗝	dng
飚	obc
榀	eddd
醯	ybo
儆	jlg
哐	dnn
遑	unu
魑	azb
嗲	dhbl
枞	ejj
笞	rkd
苌	lpc
氰	vav
馊	qpg
橐	ndwe
妤	biv
燧	chj
莅	lji
缈	iqy
邈	mupu
伲	jcv
闼	amu
庠	xgy
懑	klmh
噔	dhz
抟	uma
杈	eri
荻	lmc
逅	xfd
矾	moi
馑	qld
馥	xoe
凃	wjxh
劭	pds
昕	otj
昱	oil
栎	eby
蔫	lfs
呶	dbr
镕	zwh
庾	xpjr
柩	enxi
殇	geae
汜	kvs
迤	eeu
囿	rnv
忝	fmh
鳝	wghd
颦	sswn
苷	lzg
衮	thk
镳	zxch
飧	lqs
忸	hagt
腴	vpj
蠹	ndwc
琨	nov
觎	jvpe
谯	suc
囫	rne
飨	iqs
笏	rnes
鞯	tln
凇	wehk
淼	kkk
爻	bbi
蜚	rcc
郏	hht
饪	qtg
鋈	ktmz
蔺	lau
诜	sqp
鸢	pxn
觯	xthn
铳	zbp
呲	dsvb
湎	kbm
麋	xpm
竦	ixs
奘	agm
肽	vmi
芪	lbs
粑	pmb
缫	ioqe
膘	vvf
臾	pjr
苫	lyd
荭	liu
阗	anqh
趔	pgp
俪	jfv
滓	kwn
蜇	utc
嘣	dvvv
呦	dis
栉	elz
菟	lwt
藜	lxpk
佘	jfs
濠	kgj
稹	xnqh
佝	jgj
孱	chhh
枸	egj
疸	aof
膑	vwth
虻	cfw
箝	ruz
铩	zbe
霏	trf
濯	kzu
蝼	cpbn
乩	yda
赝	xjuo
祜	fcg
霰	tlv
盥	pka
谖	syfr
锨	zteq
徭	wya
肓	fvy
蛉	cjk
倨	jcc
硼	mvv
趺	phf
鱿	woy
埽	gbw
绉	ixb
娣	bht
楹	evr
洹	kfo
虢	ykz
詈	ysy
诨	swy
锲	zap
铰	zab
泱	kmm
绻	ihh
巽	vvl
晟	onae
桎	eyi
淦	kzj
芩	lja
锃	zdn
呤	djks
浔	kbkc
澧	kyz
羿	zlc
酆	vaa
戡	zhap
蜴	cone
渚	kqo
诮	syv
郧	dot
犷	mxg
魃	anr
崴	vnfb
砺	mxf
纥	iea
摺	uzub
讣	syb
谪	sim
颀	twy
垩	fcgt
岫	vdy
绦	ihe
馗	kho
搡	urre
璨	ngr
遨	aphu
铂	zub
眦	qsv
卟	dyb
泷	ktl
轱	ycg
铨	zjn
锟	zov
髭	pesv
纰	ivvb
蹴	pgyo
姘	bhl
榉	ekhu
粽	pwfs
赭	gcq
罅	azt
陂	trp
诟	sxf
龅	lnvs
伉	jzo
姹	bwtr
撷	ugdw
瘙	ari
鸬	ycx
秣	xfe
笥	raf
翳	norz
螨	clm
诓	snnw
晗	oja
碣	mon
箸	rqo
翕	jdzv
鹌	moax
痿	axb
赧	gcz
咭	dgd
舛	lvk
襁	tbd
诌	sxbj
跸	pvvn
蹇	wqhp
汨	kor
砭	mtr
怼	rkh
涪	kidk
薨	lyw
鲱	wrf
愎	heo
揄	ujv
窕	epww
羯	gon
醴	yyz
粕	pub
茯	ljm
鍪	ithz
钍	zgt
鹘	fx
鹘	fxn
梏	eqdk
煨	cqft
锉	zjjg
戕	apg
聒	qas
誊	hhs
陲	tll
髡	pef
郓	wyt
鄢	fsft
闳	ank
阕	ahf
湟	kun
畦	qggt
竑	inks
肱	vnks
碜	mkm
艄	iyv
衩	trid
钨	zxu
鲟	wbk
咩	dgy
艿	lvn
吒	dtr
噌	dhr
峥	vxb
徜	wss
鸨	vnx
刈	bpd
珏	nni
逡	khhu
臬	oem
褡	tlj
麂	xoj
媪	boa
玮	ngw
酢	ywa
阈	apdf
夤	lwfh
孳	hiih
钹	znr
馏	qbq
鸷	ukix
矍	qqur
裱	tat
哙	djb
幄	rcy
潍	kiu
讴	snb
砒	mvvb
呔	dmi
薏	lxh
谲	sit
驷	nys
沒	kpry
芊	llq
苁	ljj
喑	dxy
闿	avvj
俎	jjfq
阏	aljw
骞	wqhn
猷	hymq
痨	alw
肄	vobv
芨	lcj
弭	bqe
歙	jdze
氅	shv
煲	jdec
爰	yfn
璎	noo
篾	ryn
铉	zzi
厝	xlo
楫	edq
牝	qvb
稗	xut
衾	jat
豕	js
钴	zcg
徕	wah
掴	urn
桠	efc
烩	cjb
骅	njvn
啖	dcc
峁	vbm
怩	hcv
樾	epn
赍	njj
圻	gtj
碛	mao
馔	qvvh
嵘	vlwe
揿	uze
楂	eeof
茏	ltl
裟	kytt
趄	pfq
鹬	itm
囡	rbn
粥	pbb
嗪	daix
殚	ghqn
潸	keev
甑	hry
逖	mcu
錾	ytz
孬	cbh
逋	nuc
痤	ajj
佥	jkfi
炜	cgw
傥	jsp
傥	jspe
苣	lnnk
阄	awg
嵬	vag
嶂	vxn
嶂	vxns
滟	kaxm
瓯	nbrw
胝	vbi
胝	vbid
揶	uqt
揶	uqte
昶	iko
昶	ikor
杲	oem
砣	mwv
砣	mwvb
绌	ism
绌	ismk
莆	lnf
酊	yad
抻	uogs
渌	kbks
鬣	peo
鬣	peop
唁	dsy
媸	bsf
媸	bsfc
帼	rrn
帼	rrni
蠼	cqqr
铱	zti
湫	kxc
湫	kxch
發	hbr
發	hbrs
螓	cai
螓	caix
黍	xjks
遴	plvu
魍	amh
魍	amhf
踅	utpu
颏	kwy
鸩	wpx
鸩	wpxn
鼹	pow
鼹	powb
勖	oqs
勖	oqsl
洱	kqe
粳	pfo
粳	pfob
舢	ivs
薮	lpbh
鎏	kboz
镏	zbq
镏	zbqt
沤	knb
沤	knbi
猗	mmz
猗	mmzk
骓	nui
啶	dwt
啶	dwts
嬗	bzr
嬗	bzrf
獐	mxn
獐	mxns
砝	mgk
砝	mgks
竽	rfn
竽	rfns
蚝	cvm
鄯	ghdt
闶	azo
闶	azoj
鲛	wabi
恂	hno
恂	hnor
悌	hhtf
羸	fdvi
苋	lej
醛	ylj
醛	yljn
颢	ogyw
掼	ukob
棂	ebc
棂	ebch
琮	nwf
琮	nwfs
缢	ika
缢	ikam
珈	nsd
珈	nsdk
硎	mflp
耦	aqv
耦	aqvr
耨	afk
耨	afkc
螫	gchc
酩	yld
酩	yldk
掾	ubjs
痂	asd
痂	asdk
觞	xtee
骶	fbid
淝	kvm
淝	kvmb
钺	znu
峤	vtm
峤	vtmp
硒	mvx
舸	izk
疥	ajpd
脍	vjb
脍	vjby
轭	yxz
轭	yxzj
橛	exhe
蚨	chf
蜊	cxp
蜊	cxpd
螟	cwo
螟	cwoa
嗄	dfoh
榫	eun
榫	euns
炔	cnj
炔	cnjr
痈	aty
笤	rpdk
噱	dzjs
壅	ziug
猊	mpp
猊	mppe
笕	rej
讵	snn
讵	snnk
槿	eld
槿	elda
礴	mlk
礴	mlkk
钤	zja
钤	zjae
阆	aii
阆	aiig
俣	jdf
俣	jdfm
毂	gwy
毂	gwyr
荞	ltm
荞	ltmp
矸	meg
锂	zdl
阋	appe
龃	lfq
掮	umv
掮	umvy
穰	xtd
穰	xtdf
苡	lvjr
菏	lkzk
涫	kwk
涫	kwki
磬	gcrm
绡	iyvy
轸	yje
轸	yjes
焓	cja
焓	cjad
蓖	ltr
蓖	ltrv
鲧	wtis
浃	khhb
玖	nxi
玖	nxid
瓤	tddy
苜	lqm
齑	qrf
齑	qrfi
蒺	lao
蒺	laos
謇	wqhs
钏	zoc
鹜	ithx
杼	eiv
舂	aip
舂	aipj
鲂	wlf
乜	aae
烃	cru
烃	crug
莜	ljg
莜	ljgh
恹	hxm
恹	hxmq
玳	njp
玳	njpi
缗	ido
缗	idor
笫	rtf
葭	lcm
葭	lcmr
仃	jad
圜	ryf
圜	ryft
氩	vfc
氩	vfcy
蟪	cnq
蟪	cnqh
逶	xbuc
锴	zvvu
頁	wyy
龉	lwdk
俳	jrf
匦	nyk
匦	nykj
啭	dym
啭	dymi
愆	pkh
愆	pkhx
畲	jfqt
窣	ezj
窣	ezjn
姝	bta
姝	btaw
屐	cwc
屐	cwci
瑭	nxbd
稔	xja
稔	xjah
笮	rwa
葺	ldq
葺	ldqe
崧	veh
崧	vehk
赜	qao
赜	qaob
岢	vzk
挈	apu
挈	apus
潆	klwi
焱	ccch
菀	lwl
菀	lwlz
郯	cct
郯	ccte
姒	bvjr
槭	eny
槭	enyy
靛	avwt
烊	cgy
箐	rav
箐	ravy
魉	aml
牯	qcg
蛴	cqq
衽	ttgs
褓	tjde
诖	sgg
诖	sggt
帑	brr
帑	brrj
泠	kjk
泠	kjks
茑	lxn
殛	grd
殛	grdf
芾	lfr
芾	lfrj
诂	scg
诹	sqr
诹	sqry
毖	vvh
毖	vvht
炷	cin
炷	cinw
蛩	uoic
谠	ssp
谠	sspe
忾	hvq
碇	mwt
碇	mwts
郛	yht
郛	yhte
颛	vlwy
刎	nep
刎	nepd
戬	fcop
曷	onfw
柞	ewa
樯	eghd
蚴	cis
蚴	cisl
妗	bja
妗	bjae
窸	etp
窸	etph
饧	qae
饧	qaes
唳	dmmq
溴	kom
溴	komq
菖	loo
菖	loor
镉	zng
鹧	xlcx
婺	ithb
岘	vej
灏	kogw
缂	itg
蛞	cas
饔	ziuq
鸪	cxn
吡	dvv
吡	dvvb
崮	vrc
崮	vrcg
枰	eeh
枰	eehb
磔	mlv
磔	mlve
蠖	clu
蠖	clur
醚	ypuc
旎	lec
旎	lecv
氚	voc
睥	qut
睥	qutn
蛄	ccg
邳	cft
邳	cfte
阒	aqm
阒	aqmq
鬈	peh
鬈	pehz
凫	xoj
旮	kor
犍	qbu
犍	qbuy
缟	igg
蘅	lpw
蘅	lpwv
蠲	kay
蠲	kayc
鞣	tite
焖	cah
焖	cahx
缦	ioy
缦	ioyr
鲆	wehb
灞	ktt
灞	kttv
豬	jqo
豬	jqor
踽	ptd
踽	ptdv
遢	ozuc
鼋	mpdm
缁	ioq
缁	ioqt
趿	pcj
钿	zqt
颞	qrrw
鲶	wja
鲶	wjah
愍	dhh
愍	dhhx
槎	egu
槎	egug
狎	msj
缛	ifk
缛	ifkc
娌	bdl
膻	vzr
膻	vzrf
茱	lta
茱	ltaw
遒	hyuc
郴	eete
镢	zxhe
镫	zhz
镫	zhzd
髋	fwl
髋	fwle
浠	kbnr
瘛	aap
瘛	aaph
碚	mid
碚	midk
禳	ftd
禳	ftdf
羟	gru
羟	grug
臁	vxhc
蹼	pcg
蹼	pcgi
骜	aphn
佻	jpw
佻	jpww
枋	elf
苕	lpd
苕	lpdk
虼	cea
虼	ceai
醪	yzje
黩	pna
黩	pnam
劬	gsl
挲	kytu
莠	lxv
莠	lxvn
鄣	xnt
鄣	xnte
餍	xmqs
芗	lix
葩	lum
葩	lumb
娆	bpf
娆	bpfp
洙	kta
洙	ktaw
髁	fqe
髁	fqem
鲎	kww
鲎	kwwv
鲢	wyu
鲢	wyuc
祇	fbs
绀	izg
芎	lbg
讦	seg
铵	zwb
铵	zwbn
哔	dvvn
纡	ifn
纡	ifns
胍	vyg
勐	hasl
嫠	ahxb
笳	rsd
笳	rsdk
糁	pkme
芫	lmp
芫	lmpe
阍	abo
阍	abor
跏	psd
跏	psdk
鬻	bpbn
鳏	wyk
鳏	wyks
鳕	wtb
鳕	wtbj
鬻	pbbn
墀	gck
墀	gckq
帏	rgw
廪	xzr
廪	xzrf
擀	uno
擀	unoe
狷	mdv
狷	mdvy
蟊	itc
蟊	itcc
佰	jfu
佰	jfub
厣	xms
厣	xmsj
嫱	bgh
嫱	bghd
幹	none
彀	gwf
彀	gwfr
韪	otg
韪	otgw
屙	ctz
屙	ctzk
睇	qht
睇	qhtf
芏	lgt
蠓	clw
蠓	clwj
郗	bnrt
嘧	dwhv
坨	gwv
坨	gwvb
垭	gfc
垭	gfcy
聩	qcob
菸	llj
菸	lljw
裰	trr
裰	trrr
钒	zoi
钒	zoid
铆	zbm
饫	qtmd
鹚	hiix
龆	lpdk
桁	epx
濉	kqu
濉	kqui
芄	lki
芄	lkid
藿	ltu
藿	ltui
仞	jpi
仞	jpid
洮	kpw
洮	kpww
缬	igdw
褫	txz
褫	txzh
鏊	aphz
饩	qvq
仟	jlq
侩	jjb
侩	jjby
嘞	dts
嘞	dtsl
眇	qyt
眇	qytp
绔	imm
绔	imma
腚	vwt
腚	vwts
菅	lwk
菅	lwki
萸	lpj
萸	lpjr
踔	pyo
踔	pyon
妯	bdy
蚧	cjp
蚧	cjpd
垅	gtl
杷	emb
莴	ldmj
诔	sal
镒	zka
镒	zkam
鞫	tns
鞫	tnsy
勰	sss
勰	sssh
囟	trb
囟	trbi
怄	hnb
怄	hnbi
枇	evvb
溧	kve
溧	kvem
澶	kzr
澶	kzrf
绱	iss
锒	zii
锒	ziig
嘌	dvf
嘌	dvfs
掛	uggy
擤	uoql
矽	mlx
篑	rco
篑	rcob
嵊	vxa
嵊	vxav
枳	edh
枳	edhb
珩	npx
痼	arc
痼	arcg
笾	rsu
笾	rsuc
袢	thus
逄	hvu
逄	hvuc
鸹	axn
呋	dhf
撺	ued
撺	uedg
煅	cuf
煅	cufr
芡	leq
讧	sug
贽	ukio
锶	zqh
锶	zqhx
黾	dmm
幂	wom
幂	womr
樗	etma
瞽	hcq
瞽	hcqm
砉	ams
縻	zis
蚋	cmj
蚋	cmjr
蜍	cjx
蜍	cjxh
跆	pkd
跆	pkdk
亳	gtr
亳	gtrq
囵	rjl
怫	htf
桉	ewb
桉	ewbn
祢	fxy
祢	fxyx
阌	ayw
阌	ay
阌	aywr
虺	fpc
虺	fpcc
傈	jve
傈	jvem
囹	rjks
旯	okj
肼	vqj
腭	vdda
魈	ayv
魈	ayvy
卮	xfz
卮	xfzj
忪	hhk
忪	hhks
朐	vgj
滁	ktjx
笪	rof
笪	rofi
簟	rvo
簟	rvon
蜉	cyh
蜉	cyhi
衿	tja
衿	tjae
侔	jkq
侔	jkqn
堀	gcs
堀	gcsm
睚	qxg
睚	qxgg
箧	rnhh
荛	lpf
荛	lpfp
裢	tyu
裢	tyuc
貉	msg
趸	fpp
趸	fppu
镊	zqr
镊	zqrr
闫	ats
侪	jqq
悒	hdm
悒	hdmb
汊	kri
汊	krid
泫	kzi
泫	kziy
笸	rnd
笸	rndk
雎	fui
鳟	why
鳟	whyk
榧	enr
榧	enrf
獒	aphm
跎	pwvb
阃	are
阃	arem
黢	pkhh
喁	dqvr
枥	exs
枥	exsl
渑	kdm
牖	amn
牖	amnf
佤	jrw
嗍	dhs
嗍	dhsv
庥	xje
庥	xjem
眙	qkdk
筮	ruj
筮	rujj
缶	aff
餮	gjeq
嗉	dai
嗉	dais
堋	gvv
堋	gvvy
夥	qel
夥	qell
峄	vrus
拊	ujkc
昀	onwb
浯	kwd
浯	kwdk
糅	pite
綦	zhi
綦	zhis
罴	ygkc
镛	zxbt
馓	qlv
馓	qlvh
驽	brn
驽	brnm
倬	jyon
唿	dneh
柘	ems
蜢	cham
螈	cxu
螈	cxuy
佔	jyd
佔	jydk
柢	ebi
柢	ebid
茴	lrd
茴	lrdk
蟛	che
蟛	ches
鸱	bix
鸱	bixn
冼	wqpe
嘏	ccm
嘏	ccmr
堇	ldaf
岿	vpb
岿	vpbj
栀	exf
栀	exfz
氘	vpd
渫	klae
瘅	ahqn
硌	msg
箅	rqlc
翀	zdgs
腈	vavy
苎	lwfi
鲐	wkdk
咴	dnc
咴	dnch
啫	dqor
寤	waw
寤	wawd
搿	ujdu
毽	vbuy
泮	khus
秕	xvvb
蚍	cvvb
袷	tjdk
裾	tcc
裾	tccg
跬	pggt
醢	ynd
醢	ynda
搿	jduu
想	eqhx
将	alkc
些	svme
战	ydpg
物	qnes
体	jefi
或	pdfi
政	fshp
再	fmgt
却	gkzj
制	qrpd
神	fogs
斯	zhtj
便	jfob
海	kekm
教	qhhp
接	uibn
笑	rtmd
度	xlry
让	syfi
受	ywry
结	igdk
直	nqfi
命	jdzj
保	jdem
完	wmpe
管	rwki
量	ofdl
决	wnjr
形	fles
期	zhvy
资	weob
清	kavy
统	ibpe
司	afdk
住	jinw
南	nmgy
觉	kwej
基	zhgt
呢	dcvb
界	qjpd
领	jkwy
往	winw
程	xdnw
品	dddk
城	gnae
似	jvjr
请	savy
武	fpsi
深	kwhe
联	qhmd
识	sdhb
造	qduc
算	rqlc
候	jgno
整	xhfs
持	ugkc
消	kyvy
议	sibi
始	bkdk
调	smgd
团	rntp
华	jvns
脸	vjkf
府	xjkc
周	mgdk
除	tjxh
尽	ciwb
照	opdc
众	jjjr
复	eohi
陈	tryx
断	patj
价	jjpd
约	inid
病	afmj
质	xnob
称	xxyx
绝	ixmb
线	ifpg
站	iydk
刚	mbpd
增	ghro
惊	hgyx
研	mflc
易	ones
坐	jjgt
查	eofi
念	jahx
若	lndk
希	bnrj
响	dtmd
参	kmes
剑	jkfp
冷	wjks
哪	daut
图	rhwb
选	qpuc
终	ihwb
微	wvfh
局	cadk
甚	zhae
严	fcxc
营	lwdd
乎	thns
拿	jdus
答	rjdk
低	jbid
急	xbhx
较	yabi
苏	lshb
伤	jesl
举	khus
族	leos
按	uwbn
修	jghe
帝	iwrj
威	nfbn
案	wbem
底	xbid
冲	wdgs
态	mihx
构	enks
船	iodk
愿	xuyh
效	abhp
晚	owpe
例	jgpd
密	whtv
供	jlhb
沉	kwoj
察	whfs
批	uvvb
脑	vzbm
夜	zjvy
续	inam
假	jcmr
陆	tumk
网	mbbi
值	jnqf
普	hcor
停	jgad
弹	bhqn
职	qdhb
印	bfzj
织	idhb
待	wgkc
追	tkuc
您	jxyh
创	jzpd
球	nfki
树	erkc
校	eabi
怪	hrgt
激	kulh
担	uofi
顿	fswy
游	kleh
省	ytqm
背	avvy
忽	nehx
招	updk
模	elom
痛	akty
财	ontp
宝	wnid
坚	prgt
获	lmmq
劳	lwsl
挥	uwyc
敢	aqhp
压	xgid
静	avxb
范	lkzj
源	kxuy
副	fdqp
纳	imjr
跑	pnvs
述	eiuc
座	xjjg
超	ppdk
喝	donf
买	awmd
卡	yfyb
封	ggkc
富	wfdq
判	hupd
善	ghdk
降	thvk
宣	wfof
积	xdhb
靠	qdrf
阶	tjpd
楚	eets
爸	hbmb
执	ukid
呼	dthn
协	nshb
洲	kooc
检	ejkf
救	fkih
控	ueug
抗	uzoj
著	lqor
露	tpsg
伊	jbtp
莫	lomd
沙	kytp
欧	nbeq
唐	xbdk
枪	ejzj
宫	wddk
临	pror
温	koam
嘴	dsvt
航	izoj
托	utrq
索	nwis
景	ogyx
烈	gpch
秘	xhtp
架	sdem
监	pram
君	btdk
梦	eelx
税	xhdp
炮	cnvs
诸	sqor
货	jvob
松	ehks
评	sehb
恩	rmhx
探	uwhe
脱	vhdp
移	xllx
误	sdfm
释	tpru
旁	iwlf
跳	ppww
藏	lnqc
春	aior
睡	qllg
端	ivle
遗	couc
刺	empd
附	tjkc
爷	hbzj
减	wnfd
编	imic
智	odor
徐	wjxh
湖	kcvy
钟	zdgs
蒙	lwfj
丽	fvvy
康	xbks
损	udob
借	jlor
诗	sgkc
镇	znqh
吴	dfmd
域	gpdf
均	gnwb
秦	aixh
洞	kmfd
猛	mham
练	iryx
怒	brhx
禁	eefs
剧	ccpd
湾	kzcb
卖	nawm
忍	pihx
旅	leti
暴	olhk
额	wswy
含	jadk
抱	unvs
肉	mjjr
输	yjvp
缓	iyfr
销	zyvy
婚	bbor
板	exry
伸	jogs
遍	miuc
玩	nmpe
熟	ghkc
谋	szem
庭	xtgu
博	nnkc
材	entp
俄	jtup
韩	nong
混	kovv
词	safd
尊	hykc
荣	lwem
夏	fohi
谓	sqvy
授	uywr
替	hhor
摆	uygk
泽	krus
骑	nmzk
店	xydk
载	npyc
诺	slnd
健	jbuy
透	xvuc
岸	vxeg
迅	anuc
稳	xxbh
园	rmpe
坦	gofi
择	urus
握	ucyi
抵	ubid
郑	hmte
绿	ibks
篇	rmic
歌	zzeq
森	eeem
残	gfpg
妻	fbbn
塔	gljd
馆	qwki
梅	eekm
厉	xfpd
潜	khho
街	pggt
硬	mfob
宇	wfns
哭	ddmq
纵	ijjr
罢	ygks
盛	naam
萧	lbph
桌	yoem
圆	rdob
纷	ihpd
础	msmk
拜	ufaf
刑	flpd
偏	jmic
奔	mnlc
侵	jbwr
延	tsuy
懂	hlld
蒋	lalk
抬	ukdk
赞	qpqo
侧	jopd
赛	wqho
纯	ifsc
距	pnnk
途	jxuc
曹	fyor
购	onks
胸	vnbm
浪	kiig
偷	jjvp
竞	idpe
茶	ljem
毁	purs
烧	cpfp
墙	gghd
沿	kodk
爆	colk
操	udde
诚	snae
挑	upww
轰	yrry
盟	ovam
勇	ktsl
敬	lghp
迹	zcuc
哲	utdk
闭	antp
撤	ubvh
彩	yees
埃	gkos
乘	xavb
符	rjkc
筑	ruoi
培	gidk
染	kkem
稍	xyvy
妙	bytp
戴	npqh
洗	kqpe
陷	txpj
植	enqf
厚	xohi
措	ulor
援	uyfr
触	xtcc
粮	piig
洪	klhb
抢	ujzj
珠	ntaw
劲	rusl
凭	jtgo
暂	ytor
碰	mhcy
皆	vvub
忠	dghx
奉	aius
聚	qrtk
胆	vofi
倾	jvwy
吓	dfyb
驻	ninw
紫	svis
妖	btmd
凌	wghh
唱	door
梁	kphe
箭	rhvp
殊	gtaw
课	sqem
莱	lahb
鼻	oqlc
镜	zxpe
菜	lyem
恢	hnch
御	wazj
裁	npti
仪	jibi
瞧	quch
迟	ciuc
圈	rhhz
译	srus
骂	ddnm
珍	njes
惨	hkme
飘	vfob
荒	lfoc
惯	hkob
缘	ibjs
曼	oyry
旗	lezh
牌	autn
废	xsri
腰	vvbn
腿	viuc
颗	qewy
罚	yspd
拒	unnk
仰	jbzj
描	ulqt
奖	almd
贫	hpob
婆	krbn
沈	kwpe
缩	iwju
碎	mzjn
挺	utgu
泰	aiks
晓	opfp
障	txns
桥	etmp
郎	iite
讯	sans
赫	gcgc
裂	gpti
凝	wvot
泛	ktri
瑞	nvle
伴	jhus
袁	gdti
偶	jqvr
峰	vhaf
径	wrug
潮	knov
症	afsi
插	ulpj
袋	jpti
掩	umoa
浮	kyhi
倍	jidk
拔	unri
拖	ueey
悄	hyvy
狼	miig
播	utpq
丧	ghti
辩	nsnx
咬	dabi
猜	mavy
艘	ipgr
滚	kthk
贴	oydk
兽	hqfd
番	tpqt
哼	dgrl
撞	uidl
柔	item
隆	thfl
魏	xbag
糊	pcvy
崇	vwfs
赖	xxob
薄	lknk
净	wxbv
粉	phpd
偿	jsby
愤	hnlo
喵	dlqt
漫	koyr
爹	hbll
董	lldl
撒	ulvh
佩	jofr
丢	tgks
绕	ipfp
返	xruc
乔	tmpd
盾	xnqm
侍	jgkc
拳	hhus
侯	jnos
润	kanw
胞	vnvs
摄	uqrr
署	yqor
荡	lkae
递	htuc
骗	nmic
搜	upgr
幅	rfdq
奏	aifm
幽	viiy
兼	hbch
肃	bphb
辑	ydqe
岳	tfvs
黎	xpjk
污	kmae
垂	llgs
炼	cryx
苍	ljzj
箱	reqm
驾	sdnm
驱	nnbi
截	npui
拼	uhlc
涌	kkty
腾	vhhn
悉	tphx
诊	sjes
皱	xbrp
慧	aabh
漂	kvfs
蛇	cwvb
恭	lhhx
侦	jyob
钢	zmbi
贼	opns
碍	mofk
阅	ahdp
欺	zheq
牵	mwqn
综	iwfs
踪	pwfs
趋	pxbj
绪	iqor
锁	zyob
陶	tnaf
蒂	liwr
慌	hlfo
晋	fcor
惠	nqkh
储	jsqo
汤	kaes
宪	wqpe
聪	qhdh
怨	lzhx
跌	pthf
匆	neid
脉	viks
劫	gksl
宾	wthb
盗	weam
佳	jggt
哦	dtup
仗	jfbi
伪	jisi
驶	ndbi
腹	veoh
惜	hlor
胁	vshb
霸	ttvy
媒	bzem
频	sswy
弯	zcbg
颤	zrdw
键	zbuy
勤	ldas
洁	kgdk
怜	hjks
腊	vlor
贺	sdob
雾	thsl
龄	ljks
椅	emzk
熊	kvvc
询	snor
喷	dnlo
祝	fdpe
寄	wmzk
疼	ahwb
斜	jxjd
拟	uvjr
钻	zydk
浑	kwyc
惧	hqhb
叛	huxr
薛	ltkn
屈	csmk
叙	jxry
悟	hwdk
铜	zmfd
籍	ralo
沟	knks
掠	ugyx
揭	uonf
猎	mlor
诱	sxvn
娜	baut
猫	mlqt
貌	mupe
琴	nnja
寂	wyfr
遥	yauc
瓶	hlrw
昆	ovvb
辉	mwyc
吞	fmdk
晶	ooor
绩	iaob
筹	rakc
柱	einw
搬	uirs
莲	lyuc
鞋	tggt
俊	jkhh
恼	hzbm
瞪	qhzd
俱	jqhb
搭	uljd
僧	jhro
睁	qxbv
践	pfpg
猪	mqor
迈	fpuc
浅	kfpg
挣	uxbv
逻	yluc
宿	wjfu
邻	jkte
胖	vhus
丛	jjfi
跪	pxxz
傻	jtrh
脏	vxgt
廷	tguy
饰	qerj
鉴	przj
贷	jpob
葛	lonf
跨	pmma
仲	jdgs
拦	uhts
遣	ckuc
赢	fdvi
拨	usri
傅	jnkc
锦	zurj
趁	pjes
贪	jaob
削	yvpd
衰	tdfi
卓	yons
湿	kocy
瞬	qywv
桃	epww
遂	hjuc
誉	khsy
暖	oyfr
阔	akas
嫌	bhbc
碗	mwlz
涂	kjxh
挖	ueai
抑	ubzj
烂	chts
契	apmd
娃	bggt
循	wxnq
嘉	hsdk
吼	dhae
械	eplc
滴	kimc
逊	hyuc
傲	japh
吨	dfsc
浩	kqdk
姿	webn
覆	vweh
愚	qvhx
赌	oqor
煤	czem
敦	ghhp
逆	hsuc
宅	wtrq
郁	nvte
盐	gyam
玲	njks
耀	mzui
慎	hnqh
秩	xthf
涨	kbpc
饿	qtup
陵	tghh
羞	gagt
恒	hfof
纽	iagt
锐	zhdp
缝	ihau
夸	mmae
喘	dvle
碧	nums
宏	wnks
谨	slda
疏	tboc
滋	khii
串	ddgs
漠	klom
屏	chlc
悔	hekm
溜	kbqt
挨	ukos
蛮	zccc
鸿	kuxn
糟	pfyo
添	kfmh
柴	svem
屠	cqor
勉	wpsl
赐	oone
刷	crpd
捷	ufbs
喂	dqft
舱	ijzj
啥	djas
唉	dkos
磁	mhii
茫	lkfw
嫁	bwjs
菌	lrxh
催	jvui
吩	dhpd
履	cweh
乳	yhae
兹	hiiy
儒	jtle
缠	ixdl
矮	oxbn
绘	ijby
陛	tvvg
鹏	vvxn
肿	vdgs
沃	ktmd
巫	ujjr
罩	yyon
柄	efmj
缴	iulh
潘	ktpq
晴	oavy
辨	npnx
溃	kcob
婴	oobn
怖	hnrj
携	uuvn
泄	klae
翠	zzjn
霞	tcmr
酷	yqdk
癌	addv
昂	obzj
棉	eurj
剥	bkpd
卑	utns
袍	tnvs
鞭	tjfb
脖	vnwh
俘	jyhi
莉	lxpd
咽	drmd
吻	dnes
疆	bgff
饱	qnvs
抹	ufem
愣	hylf
凑	waim
芬	lhpd
朕	vhmd
畏	qfti
骤	nqrk
禅	fhqn
渴	konf
铃	zjks
填	gnqh
劣	ytsl
竭	ionf
愉	hjvp
摔	uzin
览	prej
顽	mpwy
脆	vxxz
吵	dytp
泡	knvs
毅	ijrs
扮	uhpd
腔	veug
肠	vaes
灌	kldu
壳	gwoj
屁	cvvb
饶	qpfp
狭	mhhb
摘	uimc
棋	ezhb
讼	shks
翁	hkzv
拆	utid
盒	jdam
鲍	wnvs
纲	imbi
艳	axmb
蓄	lziq
姚	bpww
漏	kctv
秒	xytp
柜	ennk
掏	unaf
哎	dlbi
於	ljwb
裤	txyc
猴	mjno
喉	djno
悦	hhdp
痴	aodk
畜	ziqt
誓	utsy
膀	viwl
厨	xzkc
撑	usus
宴	wobn
锅	zdmj
涛	kakc
盈	vram
胎	vkdk
崩	vvvy
拐	udsl
盆	hpam
砸	mnrj
刹	bepd
晕	owyc
赚	ohbc
囊	ndwt
凄	wfbb
葬	lgvl
挽	uwpe
耸	jjqe
脾	vutn
诞	stsu
懒	hxxo
斑	nvnw
後	wihi
嫂	bpgr
颠	nqhw
棵	eqem
佐	jnug
尉	cfkc
眨	qtri
陀	twvb
陕	thhb
饲	qafd
肺	vfrj
颈	ruwy
喃	dnmg
撕	uzht
驳	nbbi
酬	yooc
僵	jfqf
赠	ohro
狮	mpfr
逝	utuc
藤	lvhk
湘	keqm
棍	eovv
堵	gqor
歪	cfsi
窃	erpd
冻	wryx
陌	tfub
骄	ntmp
姻	brmd
畅	ogae
啸	dbph
抄	uytp
猩	mols
拱	ulhb
摧	uvui
菩	lidk
蓬	lhau
铭	zldk
浙	kutj
氛	vhpd
璇	nlet
琼	ngyx
锡	zone
捧	uaiu
嘱	dctv
绵	iurj
筒	rmfd
萍	lkeh
挪	uaut
辟	cdnx
钩	znks
逢	hauc
鼎	qaap
廊	xiit
吁	dfns
栏	ehts
罕	wheg
链	zyuc
溪	kyim
坑	gzoj
躯	znbi
吏	fdbi
沾	kydk
筋	rvsl
坠	tjgt
渊	kppm
葡	lnnf
寡	wwpd
捏	uogt
笨	refi
瞒	qlml
剪	hvpp
漆	kejk
阎	axpj
擅	uzrf
诡	sxxz
莎	lkyt
茅	litp
谦	shbc
淋	keem
胶	vabi
庸	xbty
衙	pwdk
媚	bcqm
逮	bkuc
宛	wlzj
骚	nric
荆	lflp
杭	ezoj
乖	lavb
姨	bmbg
哑	dfcy
嚷	dtdf
惶	hunw
咒	ddoj
镖	zvfs
窜	eddg
杖	efbi
恕	bdhx
搏	unkc
绣	ixvn
禧	fhdk
丐	fyae
碑	mutn
鹅	tupx
阐	ahqn
轿	ytmp
伞	jhns
蔽	lfhp
咐	djkc
兆	pwwb
豹	mnid
弦	bziy
薪	liet
冥	woal
捐	udvy
衷	tdgs
哇	dggt
粘	pydk
掀	uteq
脂	vvor
嘲	dnov
矩	onnk
叠	rrrf
谊	swfq
脊	wwjv
哨	dyvy
娶	qrbn
聘	qdfa
慨	hidu
俺	jmoa
嗓	drre
舅	pqsl
寓	wqvr
戚	nyfy
瘤	abqt
掘	ucsm
倡	joor
渠	knne
钓	znid
泼	ksri
瓷	werw
巢	oqem
纱	iytp
绑	iate
谱	shco
蹲	phyk
匈	nbmk
邵	pdte
蜀	yncc
篮	rpra
竖	pril
颁	hpwy
焉	fsfc
壶	gwcy
浸	kbwr
萄	lnaf
僚	jmhy
攀	ebbu
媳	bohx
嘻	dhdk
蒸	lakc
裙	tbtd
滥	kpra
愕	hdda
霜	teqm
诏	spdk
躁	pdde
憾	hnfh
巷	lhvs
勋	dosl
晰	oetj
舆	pyhb
咸	nfdk
邱	tfte
桩	exgt
诧	swtr
屡	cpbn
喻	djvp
踩	pyem
郊	abte
株	etaw
禄	fbks
厦	xfoh
卒	zjjn
聂	qrry
雁	xjui
琳	neem
耽	qwpe
咖	dsdk
煌	cunw
哄	dlhb
弊	fhlc
倦	jhhz
腺	vuks
鹤	wuxn
尴	opra
巩	uoid
焚	eech
饼	qhlc
瞄	qlqt
菊	lnpm
腕	vwlz
怯	hgks
铸	zakc
诀	snjr
绢	idvy
婉	bwlz
兜	ubnp
涅	kogt
捞	ulws
倚	jmzk
喀	dwsg
贱	ofpg
冀	avqh
溢	kkam
炭	vnch
稽	xovo
渗	kkme
罐	aldu
螺	cqis
狡	mabi
桶	ekty
塌	gozv
帆	roid
侨	jtmp
棺	ewki
荐	lngh
雌	svui
棚	evvy
靖	iavy
钧	znwb
贩	oxry
兑	hdpe
榜	eiwl
谜	spuc
毙	vvgv
麽	ztks
掷	uhmt
肾	prvy
谬	szje
锻	zufr
膨	vhes
隙	tyoy
嫩	bxhp
塘	gxbd
韵	xnwb
咨	wedk
喇	dxpd
驼	nwvb
颂	hkwy
傍	jiwl
哟	dini
霉	tekm
苹	lehb
搂	upbn
堤	gots
怡	hkdk
淘	knaf
谍	slae
藩	lktq
贬	otri
斧	hbtj
糕	pgch
俞	jvpd
颖	vxwy
砰	mehb
稻	xypj
熙	qvch
盏	fpam
襄	tddf
烤	cqfa
煮	qoch
蕴	lioa
谐	svvu
捆	urem
枕	ewpe
挟	uhhb
咧	dgpd
捡	ujkf
壤	gtdf
黛	jpph
沼	kpdk
辐	yfdq
娱	bdfm
淑	kyfr
淹	kmoa
窦	enam
呐	dmjr
迦	sduc
绅	iogs
禽	jzbv
倩	javy
彦	ixes
伽	jsdk
蹄	piwr
枢	enbi
啪	duub
搅	ukwe
羡	gweq
伺	jafd
蚁	cibi
绞	iabi
瞅	qxch
俏	jyvy
娟	bdvy
膊	vnkc
谴	scku
丙	fmjr
窥	ehej
祷	fakc
凰	ounw
绸	imgd
莹	lwni
捣	uxvs
蜡	clor
侮	jekm
眸	qkqn
逛	mnuc
炒	cytp
谣	syaf
沫	kfem
屑	cyvy
喧	dwff
莽	lmlc
龚	tlhb
撇	ufhp
梳	eboc
醇	yghi
迄	eauc
匙	otvb
嫉	baos
睹	qqor
镑	ziwl
诵	skty
嗅	domq
颊	hhwy
缚	inkc
樱	eoob
麟	xplv
逍	yvuc
潭	kvon
郝	gcte
蛛	ctaw
凳	hzoj
揉	uite
婢	butn
嗣	diad
虞	zdfm
篷	rhau
桐	emfd
缕	ipbn
贿	onvy
朽	efae
硅	mggt
钞	zytp
瑶	nyaf
隋	tnuv
憎	hhro
蔑	lyni
馨	gcro
栋	eryx
昼	ciof
腥	vols
萝	lylx
弩	brbg
碌	mbks
寝	wabr
倭	jxbn
燥	cdde
铅	zodk
砂	mytp
兮	hfae
哉	npdk
嗡	dhkz
帖	rydk
诛	staw
鳞	wplv
涯	kxgg
澄	khzd
锤	zllg
滔	kypj
寞	wlom
蹦	pvvv
敷	nlhp
霆	ttgu
褐	tonf
畴	qakc
蚕	fmcc
嚼	dyyk
奠	hymd
榴	ebqt
拙	usmk
荫	ltvy
鸽	jdxn
泌	khtp
挠	upfp
峨	vtup
蓉	lwhg
澡	kdde
蔓	loyr
泻	kwff
溅	kofp
丞	akfi
绒	ipns
熄	cohx
朦	vlwj
琢	njid
泳	kiks
凿	cgmk
惭	hytj
畔	qhus
沧	kjzj
酿	yiig
阀	ajpg
侣	jddk
拯	uakf
莺	lwxn
屿	vfaf
叟	pgry
雍	ziui
蹈	pypj
揽	upre
氢	vrug
陋	tfma
捂	uwdk
冶	wkdk
懈	hxtq
坪	gehb
蔬	ltbo
缔	iiwr
钮	zagt
娥	btup
晤	owdk
灼	cnid
舵	iwvb
澜	kaxh
茎	lrug
琉	nboc
庇	xvvb
跋	pnri
梢	eyvy
戳	zupg
蝉	chqn
毯	vcch
萎	lxbn
绰	iyon
佑	jndk
拚	uklc
窟	ecsm
硫	mboc
憋	fhhx
赎	onam
崎	vmzk
烁	cbyx
嚣	ddwd
焕	cxmm
揣	uvle
怠	kdhx
呕	dnbi
楞	eylf
潇	klbh
簇	rleo
浇	kpfp
枣	emwb
绥	iybn
僻	jcdn
榻	eozv
碟	mlae
呻	dogs
啼	diwr
虾	cfyb
棕	ewfs
萌	lovy
嫣	bfsc
鞘	tyvy
嵌	vzeq
暇	ocmr
蛟	cabi
茵	lrmd
炕	czoj
碳	mvnc
咚	dhwb
苑	llzj
厥	xhse
慷	hxbk
惕	hone
颓	xowy
悍	hoeg
匿	nlnd
禹	tdvr
簿	rknk
坤	gogs
琐	nyob
诫	splc
梵	eeoi
蝴	ccvy
尬	ojpd
涩	kpis
揪	uxch
窘	ebtd
棘	emem
盔	ncam
喔	dcyi
婶	bwog
踱	pxlr
嗜	dqor
啤	dutn
奕	zcmd
淳	kghi
镶	ztdf
晌	otmd
粪	plhb
铲	zixc
瑜	njvp
冢	wjid
庵	xmoa
扼	uxzj
佟	jhwb
绷	ivvy
棱	eghh
慑	hqrr
筷	rhnj
庶	xlch
渺	kqyt
迂	fnuc
拣	uryx
葫	lcvy
浏	kvpd
扳	uxry
嘘	dzcy
贮	owfi
窍	eufa
癫	anqw
葱	lneh
炯	cmdk
稼	xwjs
鞠	tnpm
朔	hsvy
霎	tibn
厕	xopd
眩	qziy
岔	hpvs
缆	ipre
谏	sxhb
呃	dxzj
唔	dwdk
拧	uwad
嗤	dsfc
磅	miwl
鳍	wqor
帜	rdhb
晦	oekm
搓	ugug
粥	bpbg
枫	eobi
裔	tmhd
彰	xnes
瞻	qxxs
吭	dzoj
嗽	dxeq
皓	uqdk
嚎	dgjs
拽	uoat
峭	vyvy
瓣	nynx
忿	hphx
嘀	dimc
桨	alem
梗	efob
蹬	phzd
俭	jjkf
廓	xght
碱	mnfd
迭	thuc
逞	dnuc
邸	bite
磷	mplv
绽	iwts
哆	dllx
诬	sujj
靴	tjvb
奚	yimd
宵	wyvy
蛙	cggt
沛	kfrj
硝	myvy
崛	vcsm
槽	efyo
喽	dpbn
礁	much
哮	dqhi
蜘	codk
栓	ejnw
熔	cwhg
懊	htmm
铮	zxbv
侥	jpfp
炽	cdhb
鞑	tmuc
胚	vcfi
迸	hluc
敖	aphp
轼	ypug
邢	flte
酌	ynid
悼	hyon
瑛	nlmm
掐	uxpj
缀	irrr
锣	zylx
饷	qtmd
壕	ggjs
噬	druj
絮	bdis
崭	vytj
馈	qcob
荀	lnor
岑	vjae
褚	tqor
墟	gzcy
殆	gkdk
幡	rtpq
嗔	dnqh
煽	cmzv
醋	ylor
鞍	twbn
袜	tfem
寥	wzje
罡	yfsi
缎	iufr
薇	lwvh
闺	aggt
悯	havw
咆	dnvs
毓	ekbo
颅	ycwy
钙	zfya
缪	izje
酱	alyy
痰	acch
炫	cziy
霹	tcdn
懦	htle
翩	mizv
婿	btvy
汰	kmid
捅	ukty
蟹	xtpc
箫	rbph
拴	ujnw
绊	ihus
洽	kjdk
瀑	kolk
绎	irus
驿	nrus
掳	uzsl
犀	ckqn
舷	iziy
甄	vgrw
橱	exzk
睦	qghg
嫦	bsrj
娴	baem
狞	mwad
踌	pakc
渣	keof
瘟	aoam
瞿	qqui
陨	tdob
祠	fafd
揖	udqe
膳	vghd
钝	zfsc
缉	idqe
徊	wrdk
氯	vbks
疮	ajzj
蔚	lcfk
阙	ahse
峙	vgkc
氨	vwbn
骡	nqis
闽	acc
秽	xvlx
瑚	ncvy
嬉	bhdk
肮	vzoj
狩	mwkc
咎	hydk
栈	efpg
嗨	dkek
殉	gnor
幌	romg
苔	lkdk
篱	rzbv
剃	htpd
婷	bgad
昊	ofmd
砌	mrpd
绫	ighh
悖	hnwh
炳	cfmj
呛	djzj
瞟	qvfs
嵋	vcqm
犁	xpqn
酶	yekm
榆	ejvp
霖	teem
韧	gpid
拷	uqfa
侈	jllx
肇	mhbv
舜	ywlv
兢	cpcp
臻	yaix
擂	utqt
恤	htam
隘	tkam
绮	imzk
钗	zrid
茄	lsdk
睿	ghqm
噜	dwor
跺	poem
戮	zjep
颉	gdwy
倔	jcsm
谟	slom
皖	uwmp
噩	nddd
糙	pqdu
瘾	atxh
咄	dsmk
畸	qmzk
赣	xnho
樵	euch
侃	jdoc
嫡	bimc
眶	qnnw
涤	khem
捻	ujah
捍	uoeg
屉	clae
眺	qpww
辙	ybvh
胤	pivy
褪	tiuc
翎	jkzv
婪	eebn
衅	tahu
猖	moor
捶	ullg
梧	ewdk
洼	kggt
椒	eyfr
瞳	qidl
嗖	dpgr
淀	kwts
烘	clhb
髦	pevm
稠	xmgd
羁	ytnm
璋	nxns
颌	jdwy
铝	zddk
谒	sonf
俨	jfcx
侬	jwti
疚	axid
憔	huch
晏	owbn
搔	uric
磋	mgug
篡	rqmk
毗	qvvb
瞩	qctv
殴	nbrs
唠	dlws
喳	deof
隧	thju
狰	mxbv
桔	egdk
孵	byhi
蝠	cfdq
滇	knqh
疹	ajes
黝	pisl
汴	kzyb
缰	ifqf
垢	gxfd
琅	niig
筛	rpfr
谤	siwl
曙	oyqo
蕾	ltqt
漱	kxeq
琵	nnvv
哽	dfob
呸	dcfi
睫	qfbs
蠕	ctle
筐	rnnw
惺	hols
滤	kzhx
惋	hwlz
睬	qyem
哧	dgch
椭	etnv
钵	zefi
茹	lbdk
褒	tjde
蛾	ctup
啧	daob
衲	tmjr
毡	vydk
窖	eqdk
曳	oatp
荧	lwch
跄	pjzj
菇	lbcg
诣	svor
锈	zxvn
辗	yclt
惰	hnuv
柿	ezrj
巅	vnqw
啄	djid
琛	nwhe
奄	moae
渭	kqvy
馒	qoyr
鸾	zcxn
忡	hdgs
嫖	bvfs
蝎	conf
桅	exxz
贻	okdk
鞅	tmmd
惚	hneh
拈	uydk
攒	uqpo
沌	kfsc
痊	ajnw
髯	pemg
烹	grch
咏	diks
腑	vxjk
诘	sgdk
撮	uoqr
磊	mmms
觑	zcej
忱	hwpe
亵	tuki
疙	aeai
雏	xbui
弼	bfub
缭	imhy
袄	ttmd
迥	mduc
俟	jkos
躇	plqo
鸥	nbxn
痉	arug
抨	uehb
阜	tkns
曝	oolk
隅	tqvr
堑	ytgt
槛	epra
薯	lyqo
惦	hxyd
怦	hehb
恺	hvvj
蒜	lffs
坍	gmzt
铠	zvvj
咔	dyfy
嗒	dljd
彝	bpil
淤	kljw
抉	unjr
捎	uyvy
袱	tjmq
惘	hmhf
蹿	pedg
桀	lvem
聆	qjks
褥	tfkc
阑	axhb
蹭	phro
俾	jutn
矜	itja
漓	kzbv
蔼	lsof
蕃	ltpq
鬓	pewh
辄	yqae
恻	hopd
阉	amoa
崽	vqhx
刨	nvpd
瓢	vfyg
祟	smfs
幔	royr
笋	rbtp
筝	rxbv
炬	cnnk
铎	zrus
袒	tofi
埠	gtkn
偌	jlnd
蜈	cdfm
橙	ehzd
煸	cmic
瓒	nqpo
诲	sekm
殃	gmmd
痹	aqlc
蜷	chhz
鸳	lzxn
噶	dlof
蘑	lzms
鹊	loxn
碾	mclt
芮	lmjr
悻	hggy
曦	ogxp
橄	eaqh
偕	jvvu
腋	vzjv
暧	oywr
涟	kyuc
拗	uisl
薰	llph
拌	uhus
悸	hxhi
瑙	notb
砾	mbyx
癸	hfmd
磐	irms
凋	wmgd
亟	rdrf
偎	jqft
橘	eitd
懵	hlyq
绚	inor
嚓	dwhf
肴	bnvy
碉	mmgd
蹊	pyim
忐	yfhx
钠	zmjr
笺	rfpg
娼	boor
湄	kcqm
萃	lzjn
枷	esdk
韬	gypj
祺	fzhb
悴	hzjn
蜕	chdp
踹	pvle
叼	dafi
麓	eexl
嫔	bwth
辎	yoqt
俐	jxpd
龋	ltdv
瘪	aojl
遽	zjuc
饺	qabi
怂	jjhx
屹	veai
沥	kxsl
辕	ygdt
缜	inqh
睾	tygg
讷	smjr
蚤	ricc
锭	zwts
榨	eewa
瑾	nlda
捋	uykc
骥	navh
瓮	hkrw
汾	khpd
惴	hvle
妊	btgs
惮	hhqn
馀	qjxh
帧	ryob
撂	uqsg
酵	yqhi
哒	dmuc
绛	ihvk
跤	pabi
雳	txsl
镰	zxhc
谚	sixe
卤	yrbi
筵	rtsu
桢	eyob
渝	kjvp
漾	kgik
铢	ztaw
锵	zalk
扈	mdmb
瘩	aljd
阪	txry
萦	lwis
囱	trhi
藐	lmup
侏	jtaw
吮	dkpe
莞	lwmp
匮	ncob
涣	kxmm
踞	pccg
秤	xehb
浚	kkhh
惬	hnhh
濮	kjci
螂	ciit
烽	chaf
讹	sjvb
臆	vxhx
蜒	ctsu
蜿	cwlz
蹂	pite
颍	vkwy
帚	bwrj
蟾	cxxs
遐	cmnu
螭	czbv
淄	koqt
馅	qxpj
苞	lnvs
诠	sjnw
谑	szbj
唧	dizj
蚩	sfcc
谥	skam
掖	uzjv
黔	pjae
竣	ikhh
蹋	pozv
骁	npfp
豢	hhjs
玺	xyni
饬	qesl
唰	dcrp
麒	xzhb
跷	ppfp
嗷	daph
撅	uxhe
渍	kaob
噎	dgwz
筱	rjgh
烬	cciw
瑕	ncmr
簌	rxeq
峦	zcvs
褶	tzub
铐	zqfa
盅	dgam
胭	vrmd
踵	pldl
苯	lefi
飒	iobi
镯	zync
藕	laqv
筏	rjpg
奂	xmmd
芥	ljpd
叁	kmts
憬	hogy
媛	byfr
嗳	dywr
彤	mzes
兖	akpe
嗟	dgug
挝	ukuc
癞	axxo
坯	gcfi
伫	jwfi
鹫	gyox
荃	ljnw
挎	umma
铿	zprg
谧	shta
亘	fofi
猥	mqft
刽	jbpd
媲	btrv
湍	kvle
璐	npsg
嗫	dqrr
稷	xqhh
缄	infd
垛	goem
瘢	airs
浒	ksen
逵	ghgu
鳖	fhwv
恣	wehx
诰	sqdk
旌	lels
梆	eate
捺	umfs
湮	kvgt
喏	dlnd
瀛	kfdi
踊	pkty
痔	agkc
贰	pmob
荼	ljxh
傩	jrui
蓟	lwpd
簪	rddo
飓	obqh
佚	jthf
羚	gjks
漕	kfyo
腱	vbuy
晁	opww
皋	umns
抠	unbi
髅	fpbn
楔	eapm
谄	sxpj
赡	oxxs
唷	dbvy
寐	waaw
椰	eqte
蜻	cavy
嘭	dhes
篓	rpbn
蹒	plml
玷	nydk
噼	dcdn
镀	zxlr
鑫	zzzj
琏	nyuc
娓	bcvm
犊	qnam
篆	rbjs
踝	pqem
熹	hdch
缨	ioob
璞	ncgi
坂	gxry
鹞	yaxn
剁	oepd
谩	soyr
瞑	qwoa
佼	jabi
馍	qlom
嗥	dumn
煜	coil
茉	lfem
秸	xgdk
袂	tnjr
贲	nlob
湃	kufa
迢	pduc
哞	dkqn
淞	kehk
潞	kpsg
煦	ogch
婊	bati
拄	uinw
涸	krcg
盂	fnam
虱	atcc
喙	dbjs
撸	uwor
徇	wnor
痞	acdk
咂	dnrj
豺	mntp
躏	plau
窿	ethl
诙	snch
喟	dqvy
荪	lhyx
潺	kchh
澹	kxxs
斛	xtjd
锏	zaor
恫	hmfd
骠	nvfs
唏	dbnr
绶	iywr
橹	ewor
谀	spjr
鸯	mmxn
篝	rqfg
厩	xidu
腆	vihb
夔	hosh
咻	djem
涓	kdvy
箓	rbks
轶	ythf
邃	ehju
曜	ozui
瞰	qaqh
岱	jpvs
葆	ljde
籁	rxxo
谆	sghi
槌	etku
箕	rzhb
蔗	lxlc
啾	dxch
荤	lwyc
剽	vfpd
淖	kyon
酮	ymfd
锢	zrcg
骧	ntdf
龛	jdtl
獗	mxhe
牒	alae
樟	exns
痣	aghx
檬	elwj
疵	asvb
熠	czub
睽	qhfm
泞	kwad
蚯	ctfi
蛹	ckty
畹	qwlz
怆	hjzj
罹	yhui
飕	obpr
浣	kwmp
桧	ejby
銮	zczj
睐	qahb
沅	kmpe
斓	vaxh
祛	fgks
娲	bdmj
庖	xnvs
荟	ljby
昵	ocvb
皎	uabi
罔	mhfw
槟	ewth
缥	ivfs
楣	ecqm
蛔	crdk
靥	xmbm
黜	psmk
囔	dndt
骋	ndfa
榈	eadd
妍	bflc
瘠	awwv
灸	xich
噫	dxhx
杵	eens
镁	zgmd
腌	vmoa
醮	yuch
焊	coeg
醺	ylph
黠	pgdk
侗	jmfd
裨	tutn
摞	uqis
芍	lnid
榕	ewhg
绾	iwki
擢	uzui
弈	zclc
獠	mmhy
谗	swpw
倌	jwki
圪	geai
邕	odmb
酰	yqpe
晔	ojvn
渥	kcyi
佗	jwvb
睨	qppe
蜥	cetj
镌	zuvn
冁	hqnt
蝌	cxjd
觊	vvej
暹	ouuc
锹	zxch
饴	qkdk
糯	ptle
掸	uhqn
蜓	ctgu
莓	lekm
谌	szha
囤	rfsc
嬷	bztk
酗	ybmk
蚣	chks
氪	vcpe
鳎	wozv
棣	ebks
疱	anvs
箩	rylx
阚	aaqh
龇	lsvb
镂	zpbn
徨	wunw
盹	qfsc
袤	titp
郢	dnte
蚓	cbgs
偈	jonf
咛	dwad
愠	hoam
怏	hmmd
琊	nlte
涝	klws
鹄	qdxn
芋	lfns
璀	nvui
泓	kbks
窈	eisl
畿	iipq
鹭	psxn
瑁	noqm
碴	meof
筠	rgnw
涿	kjid
龌	lcyi
婀	btzk
戛	fopg
臊	vdde
豌	zwlz
骊	nfvv
鲫	wizj
鲇	wydk
煊	cwff
罂	ooaf
娩	bwpe
蒯	lvvp
谔	sdda
骈	nhlc
洄	krdk
镣	zmhy
妲	bofi
檄	eulh
啵	dkrp
纫	ipid
俦	jakc
殒	gdob
魇	xmag
蓿	lwju
粼	plvo
绺	ihyd
圩	gfns
忑	fyhx
琬	nwlz
诋	sbid
迩	xyuc
藓	lwgy
饕	dfaq
牍	anam
蠡	bjcc
诳	smnw
霭	tsof
掬	unpm
熵	cimd
濂	kxhc
婕	bfbs
袈	sdti
镭	ztqt
皙	etub
咝	diis
褛	tpbn
臃	vziu
埂	gfob
榷	ewui
馐	qgag
孢	hnvs
鸵	xwvb
氲	voam
鲲	wovv
恸	hbsl
诿	sxbn
滂	kiwl
讫	seai
谡	sqhh
砧	mydk
荨	lbkc
辇	hhyc
冽	wgpd
椽	ebjs
泸	kycs
钛	zmid
榔	eiit
诒	skdk
覃	vons
蟮	cghd
烯	cbnr
獾	mldu
姣	babi
憩	aohx
摈	uwth
缙	ifco
嘹	dmhy
孀	bteq
洌	kgpd
祐	fndk
缇	iots
怵	heid
烷	cwmp
隍	tunw
嶙	vplv
挞	umuc
猕	mbxy
蹶	pxhe
摁	urmh
赊	ojfs
涮	kcrp
铡	zopd
狻	mkhh
遛	bquc
蝮	ceoh
坳	gisl
妫	bisi
樽	ehyk
茁	lsmk
呓	dlai
奁	mnbi
懔	hzrf
箔	rkub
钜	znnk
莒	lddk
谘	swed
佞	jmbn
铤	ztgu
纨	ikid
骛	ithn
唑	djjg
瞭	qmhy
犟	bdcq
猬	mqvy
妪	bnbi
胪	vycs
馕	qndt
谝	smic
僖	jhdk
靓	avej
簦	rhzd
饯	qfpg
涔	kvja
寮	wmhy
忤	hens
泅	krjr
胴	vmfd
蝈	crni
砷	mogs
鳅	wxch
獭	mxxo
觥	xtmg
嘁	dnyy
菠	lkrp
倜	jmgd
掇	urrr
淅	ketj
酚	yhpd
涞	kahb
繇	yati
俅	jfki
嗑	dgka
烨	cjvn
燔	ctpq
邋	opuc
旖	lemz
辔	iyid
鼐	vqaa
峋	vnor
拮	ugdk
酯	yvor
壹	gwzd
癜	aclr
饽	qnwh
蛎	cxfp
迨	kduc
偻	jpbn
媾	bqfg
馄	qovv
啕	dnaf
嗵	dktu
墒	gimd
恽	hwyc
铣	zqpe
飚	obcc
醯	yboa
儆	jlgh
哐	dnnw
遑	unuc
魑	azbv
枞	ejjr
笞	rkdk
氰	vavy
馊	qpgr
燧	chju
莅	ljil
缈	iqyt
伲	jcvb
闼	amuc
噔	dhzd
抟	umai
杈	erid
荻	lmch
逅	xfdu
矾	moid
馑	qlda
馥	xoeh
劭	pdsl
栎	ebyx
蔫	lfsc
呶	dbry
镕	zwhg
迤	eeuc
囿	rnvy
忝	fmhx
衮	thks
腴	vpjr
琨	novv
谯	such
囫	rnes
鞯	tlnh
淼	kkks
郏	hhte
饪	qtgs
蔺	laui
诜	sqpe
铳	zbpe
奘	agmd
肽	vmid
膘	vvfs
苫	lydk
荭	liug
趔	pgpd
俪	jfvv
滓	kwnx
蜇	utcc
呦	disl
栉	elzj
濠	kgjs
疸	aofi
箝	ruzg
铩	zbem
濯	kzui
乩	ydae
霰	tlvh
盥	pkam
徭	wyaf
蛉	cjks
倨	jccg
硼	mvvy
埽	gbwr
绉	ixbj
娣	bhtf
楹	evra
洹	kfof
虢	ykzh
诨	swyc
锲	zapm
铰	zabi
泱	kmmd
绻	ihhz
巽	vvlh
芩	ljae
锃	zdnw
澧	kyzd
酆	vaat
渚	kqor
诮	syvy
郧	dote
魃	anri
砺	mxfp
纥	ieai
谪	simc
绦	ihem
馗	khoi
璨	ngrp
眦	qsvb
铨	zjnw
锟	zovv
姘	bhlc
赭	gcqo
罅	aztn
诟	sxfd
伉	jzoj
瘙	aric
鸬	ycxn
秣	xfem
笥	rafd
螨	clml
晗	ojad
碣	monf
箸	rqor
痿	axbn
赧	gczr
咭	dgdk
襁	tbdc
砭	mtri
怼	rkhx
薨	lywv
愎	heoh
揄	ujvp
羯	gonf
醴	yyzd
茯	ljmq
誊	hhsy
陲	tllg
髡	pefp
郓	wyte
闳	anks
阕	ahfm
湟	kunw
碜	mkme
艄	iyvy
鲟	wbkc
吒	dtrq
噌	dhro
峥	vxbv
鸨	vnxn
珏	nnid
褡	tljd
媪	boam
钹	znri
馏	qbqt
裱	tati
哙	djby
幄	rcyi
潍	kiui
讴	snbi
呔	dmid
薏	lxhx
谲	sitd
苁	ljjr
痨	alws
氅	shvm
爰	yfnr
璎	noob
篾	ryni
铉	zziy
厝	xlor
楫	edqe
稗	xutn
衾	jati
徕	wahb
掴	urni
桠	efcy
烩	cjby
啖	dcch
怩	hcvb
樾	epnu
赍	njjo
碛	maob
揿	uzeq
鹬	itmx
甑	hryr
逖	mcuc
錾	ytzj
孬	cbhi
痤	ajjg
係	jtis
倥	jeu
倥	jeug
珐	ngk
珐	ngks
瓞	ythf
碓	mui
笊	rya
舻	iyc
舻	iycs
跞	pby
跞	pbyx
跹	plu
跹	pluc
髂	fws
髂	fwsg
鹕	cvx
鹕	cvxn
班	pnnw
斑	vnnw
辨	pnnx
辩	snnx
瓣	ynnx
瓣	ynn
辫	innx
辫	inn
弼	fubb
粥	pbbg
攀	bbeu
攀	bbe
樊	bbem
辔	yiid
掰	hpuu
懋	iteh
兜	bunp
燕	ladc
楮	eqo
楮	eqor
膈	vng
郃	jdte
铄	zby
铄	zbyx
旃	lemz
矬	ojj
矬	ojjg
砩	mtf
艏	iho
艏	ihoi
苴	lfq
荏	ljt
荏	ljtg
螯	aphc
圮	gvj
帙	rth
帙	rthf
旆	lefr
桡	epf
桡	epfp
溆	kjxr
潴	kmqo
瘘	apb
瘘	apbn
缒	itk
缒	itku
芰	lci
诎	ssm
诎	ssmk
锑	zhtf
椴	eufr
苄	lzy
苄	lzyb
陟	tss
陟	tssi
雙	uur
雙	uury
刖	vpd
啁	dmgd
悭	hpr
悭	hprg
東	eor
熘	cbq
熘	cbqt
锕	ztz
锕	ztzk
疝	avs
莸	lmo
莸	lmoy
雠	usui
鹩	mho
鹩	mhox
雠	suui
雠	suu
嗾	dle
嗾	dleo
稞	xqe
稞	xqem
蛱	chhb
赅	okh
鲋	wjkc
匏	mmav
崤	vbn
崤	vbnv
怙	hcg
砀	maes
蠊	cxh
蠊	cxhc
裣	tjkf
鹆	hxn
鼬	pdy
炝	cjz
炝	cjzj
疖	azj
硷	mjk
硷	mjkf
籴	jpm
芟	lrs
愀	hxc
愀	hxch
沆	kzo
沆	kzoj
痍	ambg
硪	mtu
硪	mtup
苤	lcfi
蔻	lwmh
蜮	cpd
蜮	cpdf
蹉	pgu
蹉	pgug
鳊	wmi
鳊	wmic
僳	jvpm
嗌	dka
嗌	dkam
崃	vah
崃	vahb
崾	vvbn
薜	lcd
薜	lcdn
跗	pjk
跗	pjkc
韫	goa
韫	goam
卣	yrn
卣	yrnk
浞	kpu
猢	mcv
猢	mcvy
獯	mlp
獯	mlph
瘿	aoob
艉	icv
艉	icvm
訇	nsy
踯	phm
踯	phmt
醍	yot
醍	yots
雱	tlf
僦	jgyo
嫒	byw
嫒	bywr
畛	qje
畛	qjes
硐	mmf
硐	mmfd
缯	ihr
缯	ihro
胨	vry
胨	vryx
鄄	vgte
锸	zlp
锸	zlpj
佶	jgd
佶	jgdk
埙	gdob
嬖	cdnb
尕	vyx
徉	wgy
怛	hof
怛	hofi
槲	extj
獬	mxtq
脲	vck
脲	vcks
鞴	tlt
鞴	tltt
鼍	ddq
鼍	ddqd
乇	trq
噻	dwq
噻	dwqg
婧	bav
婧	bavy
嵴	vww
嵴	vwwv
涑	kxs
缃	ieq
缃	ieqm
谰	sax
谰	saxh
粜	smp
粜	smpm
铧	zjvn
晷	ohy
晷	ohyd
狯	mjb
狯	mjby
狲	mhy
狲	mhyx
畈	qxr
畈	qxry
笱	rgj
逦	fvvu
钪	zzo
钪	zzoj
雲	tby
圄	rwd
圄	rwdk
榇	eie
榇	eiem
焐	cwd
焐	cwdk
肫	vfs
肫	vfsc
膂	letv
鲅	wnr
鲅	wnri
凼	kmk
珲	nwyc
锛	zmn
锛	zmnl
伧	jjz
伧	jjzj
劢	fpsl
昴	obm
猱	mit
猱	mite
癯	aqq
癯	aqqu
盱	qfn
盱	qfns
觳	gwfr
鲮	wghh
宄	wkj
椁	eghi
笄	rfl
笄	rflc
伥	jpc
厍	xyc
砻	tms
荠	lqq
蛘	cgy
塬	gxuy
挹	udmb
菽	lyf
菽	lyfr
葉	lla
葉	llae
轳	yyc
轳	yycs
鹨	zjex
亓	mpd
倮	jqem
儋	jxx
儋	jxxs
捌	udsp
氡	vhw
氡	vhwb
胗	vje
胗	vjes
钼	zqm
锆	zqd
锆	zqdk
鹁	nwhx
嚯	dtui
郾	nob
郾	nobt
铖	zna
铖	znae
鞒	ttmp
鲠	wfob
僅	jld
僅	jlda
焯	cyo
焯	cyon
锗	zqo
锗	zqor
陉	tru
陉	trug
隳	tnuh
麪	ejja
嘬	doq
嘬	doqr
杓	eni
杓	enid
枵	edf
枵	edfa
畚	kmq
畚	kmqt
盍	gka
盍	gkam
硗	mpfp
肟	vma
肟	vmae
虿	fpcc
裥	tao
裥	taor
週	mgdu
鲰	wqr
鲰	wqry
兕	mfp
兕	mfpe
垓	gkh
檩	ezrf
熳	coy
熳	coyr
邨	fst
邨	fste
鬯	pmv
鬯	pmvb
黼	cfn
黼	cfnf
狍	mnv
狍	mnvs
瓠	mmay
赀	svob
跣	pqp
跣	pqpe
龀	lvb
廠	xsh
廠	xshp
澍	khk
澍	khkc
碡	mak
碡	makm
缱	ick
缱	icku
蛑	ckqn
诶	sko
诶	skos
锩	zhhz
镧	zax
镧	zaxh
馃	qqem
鬟	pey
鬟	peyt
孑	rfi
嵯	vgu
嵯	vgug
篪	rxz
篪	rxzh
绲	iov
绲	iovv
罘	ycb
耪	aiw
耪	aiwl
茔	lwgt
蹚	psgt
鸫	ryxn
聃	qmg
聃	qmgt
谇	szjn
呖	dxs
呖	dxsl
慊	hhbc
戆	xnhh
炅	och
胼	vhl
胼	vhlc
菔	lvz
菔	lvzr
菹	lkfq
镞	zle
镞	zleo
唢	dyo
唢	dyob
砗	myc
莼	lif
莼	lifs
萋	lfb
萋	lfbb
辚	ypl
辚	yplv
鼙	hcu
鼙	hcun
傧	jwth
扦	ulq
赉	aho
赉	ahob
铍	zrp
戗	jzpg
摭	uxl
摭	uxlc
楸	exc
楸	exch
洳	kbd
洳	kbdk
萘	lmf
萘	lmfs
蘩	leki
躅	pyn
躅	pync
鲀	wfsc
嶝	vhz
嶝	vhzd
羰	gvn
羰	gvnc
胂	vog
胂	vogs
蘖	ltke
诼	sji
诼	sjid
钕	zbn
鲡	wfv
鲡	wfvv
堞	gla
堞	glae
啉	dee
啉	deem
疃	qidl
篁	run
篁	runw
蚬	cej
钋	zyb
钲	zfsi
楝	exh
楝	exhb
芤	lhae
镆	zlom
呒	ddu
楦	ewff
畀	qlc
痱	arf
鸶	iix
鸶	iixn
垡	jpgt
缣	ihbc
阊	aoo
阊	aoor
骱	fjp
骱	fj
骱	fjpd
偾	jnl
偾	jnlo
咁	dzg
廛	xdhg
瓴	jkr
瓴	jkrw
脔	zcmj
舨	ixr
舨	ixry
葎	lwb
葎	lwbv
迓	luc
崞	vghi
畋	qhp
痧	aky
痧	akyt
窳	eyy
窳	eyyg
羧	gkhh
艽	lkj
葑	lggk
蛏	crg
蛏	crgt
蜣	cga
蜣	cgae
醣	yxb
醣	yxbd
钣	zxr
钣	zxry
颎	vcw
颎	vcwy
髑	fyn
髑	fync
黧	xpp
黧	xpph
喾	kwq
喾	kwqd
帔	rrp
殄	gje
殄	gjes
甙	pzg
秫	xei
秫	xeid
蠛	clyi
踟	pod
踟	podk
逑	fkiu
镔	zwth
驺	nxb
驺	nxbj
鼗	pwwc
極	erd
極	erdf
硖	mhhb
罟	ycg
裎	tdn
裎	tdnw
蹰	pxz
蹰	pxzk
邰	kdt
邰	kdte
髌	fwt
髌	fwth
麸	ahh
麸	ahhf
岵	vcg
暌	ohf
暌	ohfm
暝	owo
暝	owoa
欹	mzeq
窀	efsc
蓼	lzje
骘	tssn
孥	brhi
幛	rxn
幛	rxns
愦	hcob
肷	veq
薹	lgd
薹	lgdy
钎	zlq
钭	zjd
镬	zlu
镬	zlur
曩	otd
曩	otdf
泔	kzg
溘	kgka
粝	pxf
粝	pxfp
荽	lybn
蚶	czg
衄	taa
衄	taag
裉	tig
鹈	htx
鹈	htxn
圉	rggy
嫘	bqi
嫘	bqis
旒	leb
旒	lebo
箪	rhq
箪	rhqn
粢	wep
粢	wepm
裼	tone
跫	uoip
酃	tddt
殳	rss
瀣	kgr
瀣	kgrf
皤	utpq
睃	qkh
睃	qkhh
脘	vwm
脘	vwmp
莪	ltup
雞	yimu
哌	dxt
哌	dxti
甯	whty
疠	afp
疠	afpd
疴	azk
胙	vwa
蚰	cdy
螬	cfyo
谵	sxxs
鐾	cdnz
钌	zrl
髮	pen
髮	peni
鳔	wvfs
彘	bvo
彘	bvov
罾	yhr
罾	yhro
鄞	ldat
醵	yzj
醵	yzjs
隹	uii
鳢	wyz
鳢	wyzd
鹪	ucx
鹪	ucxn
彘	bovv
旄	lev
旄	levm
绨	iht
绨	ihtf
蕖	lkne
虮	coj
蝽	caio
尥	oni
尥	onid
煳	ccvy
玎	nad
璁	ntr
璁	ntrh
罱	ynm
罱	ynmg
萑	lui
衝	pldl
钫	zlf
锱	zoq
锱	zoqt
悱	hrf
捩	ummq
榱	etd
榱	etdf
濞	koql
瑷	nyw
瑷	nywr
砹	mlb
砹	mlbi
窨	exy
篦	rtr
篦	rtrv
螽	hwc
螽	hwcc
憷	hee
憷	heet
磴	mhz
磴	mhzd
蘼	lzr
蘼	lzrf
褊	tmi
褊	tmic
貔	mtrv
跖	pms
辊	yov
辊	yovv
逯	bkuc
嵝	vpbn
糗	pom
糗	pomq
蝣	cle
蝣	cleh
鳚	wcf
鳚	wcfk
麇	xxh
曛	olp
曛	olph
湔	khv
湔	khvp
癔	axhx
肜	ves
醐	ycv
醐	ycvy
庀	xvb
沖	kdg
沖	kdgs
猡	myl
猡	mylx
玢	nhpd
皴	khhr
筇	rut
筇	rute
艨	ilw
艨	ilwj
袼	tsg
轫	ypi
轫	ypid
逭	wku
逭	wkuc
遄	vlu
遄	vluc
钯	zmb
髀	fut
髀	futn
敫	ulhp
朊	vmp
朊	vmpe
槔	eum
槔	eumn
沔	kfg
沔	kfga
泶	kwks
蒌	lpb
蒌	lpbn
蛲	cpfp
蹀	plae
鹾	yrbu
浼	kwpe
煙	cvg
煙	cvgt
犸	mnm
苊	lxz
苊	lxzj
薅	lbf
薅	lbfk
酽	yfc
酽	yfcx
鲔	wnvy
嵛	vjv
嵛	vjvp
樘	esg
樘	esgt
獍	mxpe
祆	ffm
祆	ffmd
窭	epbn
銎	uoiz
喱	dxd
喱	dxdl
捭	uut
捭	uutn
湓	khpa
缡	izb
缡	izbv
藁	lge
藁	lgem
迕	enu
迕	enuc
酐	yeg
靈	tddj
勝	vhhs
瞋	qnq
瞋	qnqh
偬	jne
偬	jneh
搴	wqhu
準	kuns
砬	mil
肭	vmj
肭	vmjr
舾	ivx
莩	lyh
莩	lyhi
葚	lzha
鲃	wmb
鹱	xlu
鹱	xlur
侉	jmm
侉	jmma
渖	kwog
璩	nzj
璩	nzjs
篯	rzf
篯	rzfp
糇	pjn
糇	pjno
芑	lvj
褰	wqht
铋	zhtp
鳙	wxbt
仫	jtk
仫	jtks
岣	vgj
庹	xlci
戥	olpg
杪	eyt
杪	eytp
漯	kqi
漯	kqis
甾	oqt
籼	pvs
肀	bv
锊	zyk
锊	zykc
溏	kxb
溏	kxbd
穸	elx
酡	ywv
酡	ywvb
铒	zqe
铯	zxm
铯	zxmb
鞔	twp
鞔	twpe
鲚	wqq
哏	dig
敉	php
燹	jjc
燹	jjch
豉	zci
醭	ycgi
钇	zai
锼	zpg
锼	zpgr
磙	mth
磙	mthk
祕	fht
祕	fhtp
菘	lehk
钔	zam
锜	zmz
锜	zmzk
炱	kdc
炱	kdch
茭	lab
茭	labi
锿	ztdk
骢	ntrh
仡	jea
仡	jeai
垴	gzb
垴	gzbm
炻	cms
琚	nccg
疳	azg
镗	zsgt
鸺	jex
鸺	jexn
搠	uhs
搠	uhsv
砜	mobi
陸	tghg
隰	toi
隰	toic
刿	vlp
刿	vlpd
桤	evvj
瓿	idr
瓿	idrw
缧	iqi
缧	iqis
荸	lnw
荸	lnwh
菡	lakm
馇	qeo
馇	qeof
鳇	wunw
栌	eyc
栌	eycs
溲	kpg
溲	kpgr
艚	ify
艚	ifyo
锝	zof
锝	zofk
鹮	yfdx
仵	jen
仵	jens
嶷	vvot
殍	gyh
殍	gyhi
煺	ciuc
羼	cggg
葜	lap
葜	lapm
谂	sja
谂	sjah
镅	zcq
镅	zcqm
鲷	wmgd
吣	dhx
氙	vvs
硭	mlfw
窬	ejvp
蒴	lhs
蒴	lhsv
铑	zql
哿	sdz
哿	sdzk
窆	etr
窆	etri
筌	rjn
筌	rjnw
蟥	cnh
锍	zbo
锍	zboc
鸸	lxn
佢	jnn
佢	jnnk
橥	mqoe
甓	cdnr
硇	mtrb
苒	lmg
苒	lmgt
蒡	liwl
鞲	tqf
鞲	tqfg
鸲	gxn
喹	dmgg
囧	rhm
囧	rhmk
檠	lghe
爨	pmf
爨	pmfc
艟	iid
艟	iidl
跶	pmu
跶	pmuc
辂	ysg
镓	zwj
镓	zwjs
髟	pes
涠	krg
涠	krgw
葳	lnfb
邴	fmjt
铙	zpf
铙	zpfp
锪	zne
锪	zneh
淚	kmmq
胩	vyf
胩	vyfy
镄	zto
镄	ztob
眬	qtl
蕤	ljl
蕤	ljls
遊	lehu
龢	jddx
翥	qoz
翥	qozv
幾	iin
幾	iini
耒	all
術	pei
術	peid
躔	pxd
躔	pxdg
黥	pgy
黥	pgyx
箬	rln
箬	rlnd
谮	sddo
唸	djah
傑	jlv
傑	jlve
訾	svsy
戢	dqp
戢	dqpg
樑	ekp
樑	ekpe
檑	etq
檑	etqt
襦	ttle
歃	lpe
歃	lpeq
瘌	axpd
捲	uhhz
潋	kjkh
湊	kai
湊	kaim
纛	akq
纛	akqi
蓍	lqor
徼	wul
徼	wulh
杌	efpe
芈	gyy
廢	xhbr
滹	kzt
滹	kztn
爿	app
謦	gcrs
狴	mvvg
玟	nvw
眭	qggt
貅	mje
貅	mjem
郜	qdt
郜	qdte
娈	zcbn
嫫	blo
嫫	blom
搦	ubw
搦	ubww
瑗	nyfr
疋	ts
豐	vaaz
撐	usly
殼	gwfr
柰	efs
殂	gfq
糨	pbd
糨	pbdc
绐	ikd
绐	ikdk
塗	kjxg
沭	kei
沭	keid
犴	meg
蕈	lvo
蕈	lvon
谳	snm
谳	snmm
坻	gbi
坻	gbid
怿	hru
怿	hrus
牠	qey
瑠	nbq
瑠	nbqt
翮	nzv
耋	qyi
尻	ckj
棹	eyon
阼	twa
骝	nbqt
妳	bxyx
撄	uoo
撄	uoob
柒	kre
柒	krem
侑	jnv
侑	jnvy
悝	hdl
欷	bnre
洇	krm
洇	krmd
燠	ctm
燠	ctmm
薑	lfqf
坩	gzg
媵	vhhb
徂	wfq
旰	oeg
洎	koi
澌	kzht
妧	bmp
妧	bmpe
廨	xxt
廨	xxtq
缵	iqp
缵	iqpo
裒	tpj
觇	yde
觇	ydej
兇	bmpe
崦	vmoa
採	uye
採	uyem
耧	apbn
轺	ypd
轺	ypdk
镝	zim
镝	zimc
霪	tky
霪	tkyg
喈	dvvu
眚	lqm
剡	ccpd
哓	dpf
哓	dpfp
怍	hwa
悛	hkhh
蓐	lfk
蓐	lfkc
觚	xtyg
貊	mfu
貊	mfub
卺	akfz
昝	hyor
柙	esj
栊	etl
棰	ell
棰	ellg
绂	inr
绂	inri
莳	lok
莳	lokc
蒹	lhbc
蚺	cmg
蚺	cmgt
參	kkke
嵫	vhii
幞	rcg
幞	rcgi
滏	khbz
瘗	ahhg
蓊	lhk
蓊	lhkz
蠃	fdvi
複	teo
複	teoh
豳	vjjs
遘	qfm
遘	qfmu
锞	zqem
雩	tma
雩	tmae
鬲	ngg
呙	dmjr
梃	etg
梃	etgu
確	mwu
確	mwui
秭	xtf
粵	trt
粵	trta
茕	lwan
蕞	loq
蕞	loqr
蝰	cmgg
邾	tate
髒	flg
髒	flgl
伛	jnb
伛	jnbi
暾	ogh
暾	oghh
祧	fpw
祧	fpww
腩	vnm
腩	vnmg
踣	pidk
颟	lmw
颟	lmwy
骖	nkm
骖	nkme
黻	cfni
仝	jug
堠	gjn
堠	gjno
壇	gzr
壇	gzrf
悫	gwoh
筅	rqp
筅	rqpe
缍	ill
缍	illg
缑	ijn
缑	ijno
蒽	lrmh
豸	mi
轵	ydh
轵	ydhb
陬	tqr
陬	tqry
麈	xin
麈	xinw
刳	mmap
哕	dvlx
帻	raob
桫	eky
桫	ekyt
繫	ymr
繫	ymri
纔	iwvw
臟	vln
臟	vlnq
荑	lmbg
蹁	pmi
蹁	pmic
隈	tqft
骟	nmzv
佾	jhv
佾	jhvy
剀	vvp
剀	vvpd
埒	gyk
埒	gykc
埸	gone
攮	und
攮	undt
栲	eqf
栲	eqfa
栳	eql
泺	kbyx
洧	knvy
糌	phyo
艹	lc
荦	lwq
荦	lwqn
赙	onkc
鲥	wok
鲥	wokc
圬	gma
圬	gmae
圯	gvs
塄	gyl
塄	gylf
壩	gtt
壩	gttv
妣	bvvb
忭	hzy
忭	hzyb
慝	nlnh
椟	enam
犰	mkj
瘳	azje
耜	aki
艸	lc
茌	ljgs
荇	lpx
蛸	cyvy
贳	laob
踬	pxno
郄	bnk
郄	bnkt
铗	zhhb
颃	zow
颃	zowy
鹹	yrp
鹹	yrpd
丌	lc
仳	jvvb
刭	rup
刭	rupd
劓	oqlp
哚	doe
哚	doem
唣	dur
唣	durq
屣	cws
屣	cwss
擐	uyft
晡	onf
柝	etid
檎	ejzv
歷	xxx
歷	xxxs
溷	krjs
糞	pql
糞	pqlh
習	zub
蓥	lwz
蓥	lwzj
蘧	lzju
趑	pwe
趑	pweq
趱	pqpo
邗	ete
郐	jbte
陴	tutn
颡	rrrw
傢	jwj
傢	jwjs
嘆	dld
嘆	dldh
坜	gxs
坜	gxsl
惝	hss
掎	umz
掎	umzk
柽	erg
柽	ergt
瀹	kjdd
猞	mja
猞	mjas
疔	aad
癀	anh
簋	ria
簋	riam
絷	ukii
缌	iqh
缌	iqhx
葸	lqh
葸	lqhx
郫	utnt
锔	zca
锔	zcad
镡	zvo
镡	zvon
骐	nzhb
叻	dsl
噍	duch
圹	gxg
垧	gtm
垧	gtmd
埭	gbk
埭	gbks
埴	gnqf
屍	cgv
屍	cgvb
屦	cwp
屦	cwpb
廑	xld
廑	xlda
悃	hre
悃	hrem
拶	uol
拶	uolx
昃	oxj
昃	oxjr
桴	eyh
桴	eyhi
氍	qquv
災	och
猁	mxp
猁	mxpd
瘐	apj
瘐	apjr
砑	mly
箜	reu
箜	reug
篚	rnr
篚	rnrf
绁	ila
绁	ilae
缳	iyft
芘	lvvb
萁	lzhb
蓁	laix
蓠	lzb
蓠	lzbv
酹	yyk
酹	yykc
镪	zbd
镪	zbdc
馘	hopf
鳐	wyaf
佈	jnr
佈	jnrj
垆	gyc
垆	gycs
堙	gvg
堙	gvgt
怃	hdu
憝	ghhh
扃	mmd
扃	mmdk
撙	uhy
撙	uhyk
殪	ggw
殪	ggwz
毳	vvvm
浍	kjb
浍	kjby
溱	kaix
狺	msy
珙	nlhb
瘰	aqi
瘰	aqis
眄	qfga
礅	mgh
礅	mghh
菰	lhyg
蕻	lpl
蕻	lplh
蜩	cmgd
觋	ujje
贶	odp
贶	odpe
郇	note
镩	zed
镩	zedg
髹	pej
髹	peje
黟	pll
黟	pllx
佴	jqe
坼	gti
坼	gtid
岈	vly
岙	tmv
岙	tmvs
怳	hdpe
掊	uidk
揎	uwf
揎	uwff
杩	enm
溽	kfk
溽	kfkc
牾	qwd
牾	qwdk
狃	magt
珉	ndm
矧	obg
矧	obgs
筚	rvv
筚	rvvn
箨	rur
箨	ruru
糍	phii
绗	ipx
舄	pnc
舄	pnch
舳	idy
艋	iham
茳	lku
茳	lkug
蝾	clwe
觌	nawe
觜	svx
觜	svxt
貘	mlom
轹	ybyx
酎	ykc
酤	ycg
醜	yag
铫	zpw
铫	zpww
镟	zlet
镥	zwo
镥	zwor
陔	tkh
骀	nkd
骀	nkdk
髫	pep
髫	pepd
龠	jddd
兌	hdpe
坫	gyd
坫	gydk
埝	gja
埝	gjah
彖	bjs
戽	mjd
揸	ueo
揸	ueof
摅	uzhx
枘	emj
枘	emjr
柁	ewv
柁	ewvb
栝	eas
沩	kis
沩	kisi
皲	wyr
皲	wyrp
瞀	ithq
筲	ryv
筲	ryvy
篼	rubp
糈	ptv
糈	ptvy
綮	mhis
羝	gbid
茆	lbm
茛	lig
荜	lvvn
蔸	lub
蔸	lubp
薤	lgr
薤	lgrf
趵	pni
趵	pnid
跽	pvh
跽	pvhx
辋	ymh
辋	ymhf
鲵	wpp
鲵	wppe
鲼	wnl
鲼	wnlo
鹣	hbcx
篼	rbup
蔸	lbup
仉	joj
垲	gvvj
埕	gdn
埕	gdnw
妁	bni
妁	bnid
孓	rid
忉	hpd
忮	hci
慾	hehx
戋	fpg
挢	utm
挢	utmp
揠	unob
桄	emg
桷	ext
桷	exty
棼	eehp
檫	ewhf
毹	jvpv
洫	ktam
淩	kghh
滠	kqr
滠	kqrr
漭	klml
爝	cyy
爝	cyyk
狳	mjx
狳	mjxh
珧	npw
珧	npww
畎	qmq
疬	axs
疬	axsl
痦	awd
痦	awdk
瘊	ajno
瘼	alo
瘼	alom
瞢	lywq
祓	fnr
祓	fnri
籀	rubq
纩	ixg
聱	aphq
脞	vjjg
腠	vaim
莨	lii
莨	liig
萆	lut
萆	lutn
蒉	lco
蒉	lcob
蕺	ldqp
蝤	chy
蝤	chyy
蝻	cnmg
襻	teb
襻	tebu
觏	qfme
赆	oci
赆	ociw
趼	pfl
趼	pflc
醅	yid
醅	yidk
铊	zwv
铊	zwvb
镲	zwhf
阽	tyd
阽	tydk
鲽	wla
鲽	wlae
鳜	wxhe
鹇	aex
鹇	aexn
襻	tbbu
襻	tbb
儇	jyf
儇	jyft
劂	xhsp
坌	hpg
坌	hpgt
坭	gcv
坭	gcvb
坶	gkm
埏	gts
埏	gtsu
埤	gut
埤	gutn
帱	rakc
恥	qhx
恧	lhx
擗	ucd
擗	ucdn
枧	eej
桿	eoe
桿	eoeg
楗	ebu
楗	ebuy
檗	cdne
汆	jks
汔	kea
汔	keai
淠	kql
淠	kqlc
漶	kddh
澉	kaq
澉	kaqh
狁	mkp
狁	mkpe
璺	pmfi
甍	lywr
瘵	ahfs
禊	fap
禊	fapm
箦	raob
篌	rjno
绠	ifo
绠	ifob
舡	iug
舴	iwa
葶	lga
葶	lgad
蔟	lle
蔟	lleo
蠟	cop
蠟	cops
襞	cdnt
觖	xtn
觖	xtnj
赇	ofk
赇	ofki
躐	pop
躐	pops
躜	pqpo
轾	yyi
邡	lte
骒	nqem
鬏	pex
鬏	pexc
鲞	hhwv
鳘	ekhw
黉	kwnh
鼷	pyim
俜	jdfa
僬	juch
劁	ucp
劁	ucpd
哳	dutj
垌	gmf
垌	gmfd
垸	gwm
垸	gwmp
塍	vhhg
墁	goy
墁	goyr
屺	vvj
岜	vmb
岡	mhv
岡	mhvs
廒	xap
廒	xaph
弔	bgs
復	weoh
揲	ula
揲	ulae
搌	ucl
搌	uclt
搛	uhbc
攉	utui
枨	epc
柃	ejks
桊	hhe
桊	hhem
椐	ecc
椐	eccg
椠	ytem
椹	ezha
樨	eck
樨	eckq
橼	eib
橼	eibj
毵	kmev
氆	vhco
氽	jks
泐	ktsl
溻	koz
溻	kozv
潲	kxy
潲	kxyv
猃	mjkf
甏	her
甏	herw
眍	qnb
眍	qnbi
瞍	qpgr
瞵	qpl
瞵	qplv
砘	mfsc
碹	mwf
碹	mwff
磲	mkn
磲	mkne
篥	rve
篥	rvem
簏	rxl
绋	itf
缲	idde
罨	ymo
罨	ymoa
耩	aqf
耩	aqfg
脬	vyh
脬	vyhi
腧	vjvp
舣	iib
舣	iibi
舯	idg
舯	idgs
芴	lnes
蒇	lnob
蓰	lwss
蔌	lxe
蔌	lxeq
薦	lxf
薦	lxfc
蝥	ithc
褙	tav
褙	tavv
豇	zug
邶	avt
邶	avte
酞	ymi
酞	ymid
酲	ydn
酲	ydnw
酾	yfv
酾	yfvv
钐	zes
锬	zcch
锾	zyf
锾	zyfr
镙	zqi
镙	zqis
陧	tog
陧	togt
顸	ewy
鲭	wav
鲭	wavy
黹	cfb
鼢	phpd
㞎	cmb
佧	jyfy
傺	jhfs
冱	wfbj
剞	mzp
剞	mzpd
唪	daiu
唼	dib
唼	dibn
埚	gdm
埚	gdmj
堍	gwt
墼	ymrg
夼	moc
尜	ymy
尜	ymyx
岽	vryx
庳	xutn
彳	wcc
恝	aphx
捃	ubt
捃	ubtd
桕	epj
榍	ecy
榍	ecyv
氵	ks
泖	kbm
浈	kyob
滗	krv
滗	krvm
瀵	kpq
瀵	kpqh
犋	qqh
犋	qqhb
瘕	acm
瘕	acmr
瘥	agu
瘥	agug
癃	ath
癃	athl
癍	anvn
眢	lzq
眢	lzqm
眵	qllx
礓	mfqf
稂	xiig
筢	rum
筢	rumb
箢	rwl
箢	rwlz
缋	ico
缋	icob
膣	vey
膣	veyi
臌	vhc
臌	vhci
艴	txm
艴	txmb
茚	lbfz
茺	lbpe
茼	lmfd
莛	ltg
莛	ltgu
萏	lxpj
蜞	czh
蜞	czhb
蝓	cjvp
赕	occ
赕	occh
蹯	ptp
蹯	ptpq
酴	yjx
酴	yjxh
钅	zj
钬	zch
铴	zkae
锇	ztu
锇	ztup
镘	zoy
镘	zoyr
霈	tkf
霈	tkfr
颥	tlw
颥	tlwy
飑	obn
飑	obnv
驵	nfq
鬆	pee
鬆	peek
鲦	whem
鲳	woo
鲳	woor
鹛	cqx
鹛	cqxn
癍	avnn
䌷	idy
亍	wc
仂	jsl
劐	lur
劐	lurp
厶	ks
叆	bywr
吲	dbg
吲	dbgs
哜	dqq
唛	dah
唛	dahi
嚆	dlg
嚆	dlgg
囝	rhi
圊	ravy
垤	gyi
埘	gok
埘	gokc
埯	gmo
埯	gmoa
墚	gkp
墚	gkpe
奻	bbn
嫜	bxn
嫜	bxns
宀	wg
岍	vfl
岍	vflc
巯	rubo
戤	vrap
扌	uss
掭	ufm
掭	ufmh
揞	uxy
曶	neo
曶	neor
楱	eaim
槠	esq
槠	esqo
沲	keey
洚	khvk
炘	ctj
烀	cth
烀	cthn
牿	qqd
牿	qqdk
犏	qmi
犏	qmic
猸	mcq
猸	mcqm
猹	meof
疰	ain
疰	ainw
痖	afc
痖	afcy
瘃	aji
瘃	ajid
瘖	axy
眾	yjj
眾	yjjj
砟	mwa
砼	mju
砼	mjug
碲	miwr
磉	mrr
磉	mrre
稆	xdd
稆	xddk
筘	rud
筘	rudk
筻	rfo
筻	rfob
粞	pvx
糸	is
缏	ijf
缏	ijfb
耔	ahi
耠	ajdk
耱	azm
耱	azms
耵	qad
聍	qwa
聍	qwad
胬	brmj
胲	vkh
脒	vpm
腽	voam
膦	vplv
舭	ivvb
苈	lxs
苈	lxsl
苘	lmd
苘	lmdk
茇	lnr
茇	lnri
茈	lsvb
荬	law
荬	lawm
菝	lun
菝	luni
菪	lwms
菴	lmoa
萜	lry
萜	lryd
蕹	lziu
薷	ltle
蚵	czk
蜱	cut
蜱	cutn
蜾	cqe
蜾	cqem
螋	cpg
螋	cpgr
螵	cvf
螵	cvfs
蟓	cwx
觫	xtx
觫	xtxs
谫	shvp
跡	pzc
跡	pzch
踺	pbu
踺	pbuy
躞	psc
躞	pscr
辁	yjn
辁	yjnw
迮	wuc
鄹	qrtt
醑	ytv
醑	ytvy
釒	zj
钶	zzk
钸	znrj
钽	zofi
铈	zzr
铈	zzrj
铌	zcvb
铘	zlt
铘	zlte
铞	zdr
铞	zdrj
铟	zrm
铟	zrmd
铪	zjdk
铼	zah
铼	zahb
锎	zaf
锎	zafl
锓	zbw
锓	zbwr
锖	zav
锖	zavy
锘	zln
锘	zlnd
锫	zid
锫	zidk
镎	zjdu
镦	zgh
镦	zghh
镨	zhc
镨	zhco
镱	zxhx
阢	tfp
阢	tfpe
骍	nnx
骣	nchh
鲒	wgd
鲒	wgdk
鲣	wpr
鲣	wprg
鲩	wwmp
鲻	woq
鲻	woqt
鳆	weoh
鹋	lqx
鹋	lqxn
鹎	utnx
黪	pkme
鼯	pwdk
齄	oqlf
𡗗	aid
𤆵	cmb
𫟷	zil
𰙤	fsfs
々	xid
〇	dkk
の	aee
㐎	vai
㑇	jxbj
㑊	jzc
㑊	jzch
㑌	jnnw
㑩	jyl
㑩	jylx
㑺	juv
㑺	juvn
㓥	ybp
㓥	ybpd
㓦	fup
㓦	fupd
㕠	wur
㕠	wury
㕥	djr
㕮	dhbi
㖊	dbk
㖊	dbkc
㖞	ddmj
㗏	dcfs
㗑	duf
㗑	dufa
㗒	dtdk
㘄	deyl
㘎	daa
㘎	daah
㘗	dqqu
㘥	ryai
㘰	gjd
㘵	gnr
㘵	gnrj
㙍	grr
㙍	grrr
㙘	gvb
㙘	gvbn
㙟	giiv
㙦	jxjg
㚢	jbn
㚣	bbn
㚰	bcf
㚰	bcfi
㚻	qbn
㚽	ufab
㛃	apbn
㛅	bqe
㛚	bkt
㛚	bkty
㛹	bjf
㛹	bjfb
㜅	bziq
㝀	khi
㝹	ytw
㝹	ytwt
㝿	orp
㞗	cfki
㞘	cji
㞘	cjid
㞞	cwj
㞞	cwjs
㞢	sfi
㟂	vkm
㟃	vaf
㟃	vafd
㟖	vnl
㟖	vnlc
㟤	vbks
㠇	vgyo
㠓	vlwj
㠮	hcou
㠯	ki
㡀	fb
㤅	dhx
㤘	hxbj
㤙	rnhx
㤞	hwtr
㤥	hkh
㤭	htmp
㥄	hghh
㥏	hih
㥏	hihb
㧀	mcj
㧐	urry
㧑	uisi
㧟	ukn
㧟	uknk
㧥	uqpe
㧯	uql
㧱	jdus
㨃	ugh
㨃	ughi
㨄	umgd
㩟	uwq
㩟	uwqe
㩳	uuur
㪗	idhp
㫚	neor
㫰	oii
㫰	oiig
㬊	oyfr
㬎	oiic
㬚	obv
㬚	obvh
㬤	ooi
㬤	ooic
㭎	embi
㭕	egk
㭕	egks
㮾	iive
㯊	efsc
㰀	exp
㰀	expk
㱔	svl
㱔	svlx
㳇	khbi
㳘	kbpe
㳚	kni
㳚	knid
㳠	kmu
㳠	kmuc
㴔	kxbh
㴩	kodm
㵐	kxhe
㵘	kkkk
㵲	kel
㵲	kelv
㶁	kyk
㶁	kykz
㶉	kyix
㶲	cty
㸆	cqd
㸆	cqdr
㸌	ctui
㹢	msd
㹢	msdk
㹧	mmmd
㹭	moat
㹴	mfob
㺄	mjv
㺄	mjvp
㺢	mtui
㺭	nhi
㻋	nxs
㻪	nuv
㻪	nuvn
㻬	ntma
㽏	kjdz
㽒	qsls
㿠	umg
㿢	ovu
㿢	ovub
䀇	caa
䀇	caam
䀦	qcg
䁖	qpb
䁖	qpbn
䂮	apms
䃅	mhq
䃅	mhqn
䃎	mml
䃎	mmll
䃰	mwh
䃰	mwhf
䄉	ftu
䄉	ftup
䅟	xkm
䅟	xkme
䇽	rutj
䌹	imd
䌹	imdk
䍉	adh
䍉	adhb
䎃	mgz
䎃	mgzv
䎖	hryz
䎜	qql
䏝	vmai
䏡	vfs
䏲	vht
䏲	vhtf
䏿	mhvy
䐃	vrx
䐃	vrxh
䐛	vmq
䐛	vmqe
䒕	lyx
䒟	lmz
䒟	lmzt
䓂	lsy
䓖	lesl
䓛	lcs
䓛	lcsm
䓞	lmmq
䓤	lneh
䓨	lwaf
䓫	lmzk
䓬	lyo
䓬	lyon
䕷	lzis
䖋	zjr
䖢	cytp
䗖	clwr
䗛	cjg
䗛	cjgv
䗪	xlcc
䗴	crt
䗴	crtu
䙆	thfm
䙌	tco
䙌	tcob
䜣	stj
䜩	sldc
䜺	zlor
䝋	jwfs
䝙	mnbi
䞍	oavy
䟡	pbid
䢺	smt
䢺	smte
䢼	lht
䢼	lhte
䣘	sgte
䥽	zsr
䥽	zsri
䦃	zlqo
䦆	zqq
䦆	zqqr
䦶	axbv
䦷	ajjg
䩄	bej
䯄	ndmj
䯼	pemc
䰀	pexb
䲝	wjz
䲝	wjzj
䲟	wbf
䲟	wbfz
䲠	waio
䲢	vhhw
䴓	frx
䴓	frxn
䴔	abx
䴔	abxn
䴕	gpx
䴕	gpxn
䴖	avxn
䴗	qmx
䴗	qmxn
䴘	xzx
䴘	xzxn
䴙	cdnx
䶭	tnw
䶮	tfmd
丄	gfi
丅	fgs
丏	fga
丏	fgaa
丨	gss
丬	ap
丶	idd
丼	qid
丿	tpp
乀	id
乂	bi
乄	aid
乆	ajr
乕	xur
乕	xurj
乛	ae
乸	ekm
亅	gs
亖	mme
亠	ztt
亶	zrdf
亸	ghhn
亹	zpmf
亻	jrr
亾	fww
仌	jjr
伈	jhx
伋	jcj
伕	jhf
伡	jyc
伣	jej
伬	jcid
伭	jzi
伭	jziy
伱	jjy
伱	jjyx
伻	jeh
伻	jehb
伾	jcf
伾	jcfi
佀	jki
佁	jkd
佁	jkdk
佉	jgks
佖	jht
佖	jhtp
佷	jig
佸	jas
佹	jxxz
佺	jjn
佺	jjnw
佽	jwe
佽	jweq
侁	jqp
侁	jqpe
侂	jxt
侂	jxtr
侘	jwtr
侜	jio
侴	jagp
侷	jca
侷	jcad
侹	jtgu
侻	jhdp
俍	jii
俍	jiig
俙	jbnr
俤	jhtf
俫	jahb
俵	jati
俶	jyfr
倅	jzjn
倐	jghc
倓	jcch
倕	jllg
倖	jggy
倞	jgyx
倧	jwfs
倴	jmn
倴	jmnl
倷	jmfs
倻	jqte
偁	jym
偁	jymg
偆	jaio
偊	jtd
偊	jtdv
偍	jot
偍	jots
偐	jix
偐	jixe
偓	jcy
偓	jcyi
偡	jzh
偡	jzha
偢	jxc
偢	jxch
偭	jbm
偰	japm
偲	jqhx
傃	jais
傉	jfkc
傎	jnqh
傒	jyim
傕	jwui
傚	jabh
傝	joz
傝	jozv
傭	jxbt
僇	jzje
僎	jvvh
僔	jhy
僔	jhyk
僕	jcgi
僙	jnh
僜	jhz
僜	jhzd
僝	jchh
僰	emej
僽	jxch
儁	jum
儁	jumk
儓	jgdy
儗	jvot
儚	jlyl
儦	jxch
儳	jwvw
儴	jtdf
儾	jndt
兎	wt
兙	cpn
兙	cpns
兛	cpl
兛	cplq
兝	cph
兝	cphp
兞	cpv
兞	cpvm
兡	cpfu
兣	cpxd
兲	nhb
冂	mkk
円	vyy
冇	nmk
冏	mhd
冏	mhdk
冑	dvy
冓	qfmg
冔	odf
冔	odfn
冖	wg
冧	wee
冧	weem
冫	wbb
冮	wug
冴	wly
冸	whu
冸	whus
凊	wavy
凓	wve
凓	wvem
凘	wzht
凪	osi
凵	mk
刂	pd
刌	kpd
刓	mppd
刜	tpd
刬	fppd
刲	ggp
刲	ggpd
刵	qpd
剅	zpd
剉	jjgp
剋	cpp
剋	cppd
剏	hlp
剏	hlpi
剒	lop
剒	lopd
剕	rpd
剚	fdbp
剟	rrrp
剳	ljdp
剸	nqkp
剹	zjep
剺	ahxp
劀	itmp
劃	bqfp
劄	rjdp
劏	sqpd
劘	zrpd
劙	bjcp
劵	hhsl
劻	nns
劻	nnsl
劼	gds
劼	gdsl
勍	gys
勍	gysl
勔	bsl
勚	laos
勠	zjes
勥	bdcs
勷	tdds
勹	nkk
勼	nkj
匄	nfw
匚	nk
匜	ney
匼	njd
匼	njdk
卌	lxx
卍	aaa
卍	aaaa
卐	aaaa
卩	zj
卬	bzj
卲	pdz
卲	pdzj
卼	fpx
卼	fpxz
厃	xxc
厔	xyi
厖	xoes
厷	nks
厾	agks
叇	bbk
叇	bbku
叒	rrry
叕	rrrr
叚	cmnr
叡	ghqr
吋	dkc
吔	dey
吖	dhg
吖	dhgs
吚	dbt
吚	dbtp
吥	dcb
吪	djvb
吰	dnk
吰	dnks
吽	dqn
呇	kdk
呌	djd
呎	dcid
呝	dma
呝	dmai
呣	dkm
呯	deh
呯	dehb
呴	dgj
呾	dof
呾	dofi
咇	dht
咇	dhtp
咉	dmmd
咍	dkd
咍	dkdk
咑	dua
咑	duad
咗	dnug
咠	dqe
咡	dqe
咥	dyi
咮	dta
咮	dtaw
咲	dhm
咲	dhmd
咷	dpw
咷	dpww
咺	dfof
哃	dmf
哃	dmfd
哋	dge
哋	dgey
哖	dev
哖	devk
哢	dnlc
哱	dnwh
唗	dpz
唝	duo
唝	duob
唞	duj
唞	dujd
唡	dml
唦	dky
唦	dkyt
唵	dmo
唵	dmoa
唶	dlor
啈	dggy
啗	dxpj
啙	svd
啙	svdd
啛	dfb
啛	dfbb
啯	drn
啯	drni
啰	dyl
啰	dylx
啱	dvm
啱	dvms
啲	duni
啴	dhq
啴	dhqn
喆	gdg
喆	gdgd
喌	ddoo
喎	dfd
喎	dfdk
喓	dvbn
喤	dun
喤	dunw
喨	dgo
喨	dgoj
喭	dix
喭	dixe
喰	dqs
喺	djt
喺	djti
喼	dxb
喼	dxbh
喿	ddde
嗈	dod
嗈	dodm
嗙	diwl
嗛	dhbc
嗞	dhi
嗞	dhii
嗮	dov
嗮	dovx
嗰	djrc
嗱	djdu
嗻	dxl
嗻	dxlc
嗼	dlom
嘅	did
嘅	didu
嘑	dzt
嘑	dztn
嘒	daab
嘚	dwok
嘡	dsgt
嘢	ddi
嘢	ddiv
嘦	dhv
嘦	dhvb
噀	dvvh
噂	dhy
噂	dhyk
噃	dtp
噃	dtpq
噆	dddo
噇	didl
噉	daq
噉	daqh
噏	djdz
噷	dxeq
嚃	dyk
嚃	dyku
嚄	dlu
嚄	dlur
嚚	ddqd
嚜	dpgt
嚟	dxpk
嚡	dtg
嚡	dtgg
嚥	dldc
嚭	hdcd
嚱	dzz
嚱	dzzp
囌	dlwx
囍	hdhd
囗	rkk
囘	mvs
囙	rnk
囥	rzo
囥	rzoj
囮	rjv
囮	rjvb
囯	rnw
囷	rxh
圀	rhl
圀	rhlf
圂	rjs
圌	rvl
圌	rvle
圐	rylf
圙	rhb
圙	rhbm
圢	gad
圫	gtrq
圲	glq
坉	gfs
坉	gfsc
坋	ghpd
坒	vvgt
坢	ghu
坢	ghus
坥	gfq
坬	gyg
坰	gmd
坰	gmdk
坽	gjks
垇	gmfi
垈	jpgt
垍	goi
垎	gsg
垏	gbv
垕	xfdg
垙	gmg
垚	ggg
垚	gggt
垝	gxx
垝	gxxz
垞	gwtr
垟	ggy
垯	gmu
垯	gmuc
垰	gyf
垰	gyfy
垱	gyb
垱	gybj
垵	gwb
垵	gwbn
垺	gyhi
垽	ktg
垽	ktgt
垾	goeg
垿	gxi
垿	gxiv
埆	gxt
埆	gxty
埇	gkt
埇	gkty
埌	gii
埌	giig
埗	gssi
埪	geu
埪	geug
埫	gss
埮	gcc
埮	gcch
埵	gllg
埻	gghi
埼	gmzk
堃	llgt
堄	gpp
堄	gppe
堉	gbvy
堌	grcg
堎	gghh
堐	gxgg
堘	ghhg
堧	glm
堧	glmd
堨	gonf
堩	ghf
堩	ghff
堲	izgt
堶	gnu
堶	gnuv
堺	gqj
堺	gqjp
堼	ggkg
堽	gyfs
堾	gai
堾	gaio
塃	glfo
塅	guf
塅	gufr
塆	gzcb
塈	idgt
塕	ghkz
塚	gwj
塚	gwji
塝	giw
塝	giwl
塟	lgvg
塥	gng
塨	glh
塨	glhh
塮	gzkc
塱	iivg
塽	gmbb
墈	gzhs
墋	gkk
墋	gkke
墐	gld
墐	glda
墕	gfsc
墘	gnoa
墡	gghd
墣	gcgi
墦	gtp
墦	gtpq
墬	tbjg
墺	gtmm
壎	glp
壎	glph
壜	gotb
壴	huu
壸	gwfc
夂	hi
夆	haf
夐	xmj
夐	xmjh
夬	njr
夿	mmb
奀	cmd
奅	mbm
奆	mnn
奆	mnnk
奓	mll
奓	mllx
奡	fom
奡	fomp
奣	fmo
奣	fmov
奤	mbm
奭	mfuu
妑	bmb
妘	bby
妭	bnri
妷	bth
妷	bthf
妸	bzk
妺	bfe
妺	bfem
姁	bgj
姈	bjk
姈	bjks
姕	svb
姕	svbn
姛	bmf
姛	bmfd
姞	bgd
姞	bgdk
姤	bxf
姤	bxfd
姦	bbb
姦	bbbn
姪	byi
姮	bfo
姮	bfof
姱	bmma
姶	bjd
姶	bjdk
姽	bxx
姽	bxxz
娀	bpn
娀	bpns
娒	bek
娒	bekm
娖	bpu
娚	bqs
娚	bqsl
娵	bqr
娵	bqry
娸	bzhb
娿	tzb
娿	tzbn
婋	bzh
婌	byfr
婍	bmz
婍	bmzk
婗	bpp
婗	bppe
婘	bhhz
婞	bggy
婠	bwk
婠	bwki
婤	bmg
婤	bmgd
婥	byon
婫	bov
婫	bovv
婬	bytg
婳	bfqm
婻	bnmg
婼	bln
婼	blnd
媂	biw
媂	biwr
媄	bgm
媄	bgmd
媆	blm
媆	blmd
媓	bun
媓	bunw
媕	bjdl
媖	blmm
媞	bot
媞	bots
媟	bla
媟	blae
媢	boq
媢	boqm
媭	ewbn
媮	bjv
媮	bjvp
媱	bya
媱	byaf
媺	bvfh
媿	bag
嫄	bxu
嫄	bxuy
嫋	bbw
嫋	bbww
嫏	biit
嫑	cvbn
嫕	bno
嫕	bnoh
嫚	boy
嫚	boyr
嫛	norb
嫪	bzje
嫭	bztn
嫮	btma
嫳	fhb
嫳	fhbn
嫽	bmhy
嬛	byft
嬢	bthf
嬬	btl
嬬	btle
嬿	bld
嬿	bldc
孃	btdf
孅	bjjf
孖	hhi
宧	wqc
宬	wna
宬	wnae
寀	wye
寀	wyem
寁	wfbs
寔	wot
寔	wots
尒	jyx
尛	yyy
尛	yyyx
尢	oyy
尨	oes
尪	onw
屃	cob
屄	cex
屌	cdr
屌	cdrj
屮	sc
屲	tvs
屴	vsl
屻	vpi
屻	vpid
屼	vfpe
屾	vvs
岃	vpid
岊	mvs
岕	vjp
岕	vjpd
岞	vwa
岠	vnn
岠	vnnk
岦	vil
岧	vpdk
岨	vfq
峂	vhwb
峃	kwvs
峉	vsg
峎	vig
峗	vxxz
峘	vfof
峛	vgp
峛	vgpd
峣	vpf
峣	vpfp
峧	vabi
峬	vnf
峱	magv
峿	vwd
峿	vwdk
崀	viig
崁	vge
崁	vgeq
崄	vjkf
崌	vccg
崐	vov
崐	vovv
崒	vzjn
崚	vghh
崟	vzj
崡	vak
崡	vakm
崶	vggk
崿	vdda
嵁	vzh
嵁	vzha
嵅	vnfd
嵎	vqv
嵎	vqvr
嵖	veof
嵚	vzeq
嵲	voe
嵲	voem
嶅	aphv
嶍	vzu
嶍	vzub
嶒	vhr
嶒	vhro
嶓	vtpq
嶕	vuch
嶟	vhy
嶟	vhyk
嶦	vxxs
嶰	vxt
嶰	vxtq
嶲	vum
嶲	vumk
嶽	vmsm
巇	vzz
巇	vzzp
巉	vwv
巉	vwvw
巎	vfoh
巛	oc
巭	ush
巭	ushf
帋	brj
帡	rhlc
帨	rhd
帨	rhdp
帩	ryvy
帵	rwlz
幈	rch
幈	rchl
幖	rvf
幖	rvfs
幧	rdde
幪	rlw
幪	rlwj
幵	eeg
広	xks
庤	xgk
庤	xgkc
庱	xghh
庼	xvw
庼	xvwy
廆	xag
廋	xpg
廋	xpgr
廙	xql
廙	xqlh
廴	uyy
廻	rdu
廻	rduy
廾	lc
弆	gkl
弆	gklc
弇	jdlc
弌	pfi
弍	pme
弎	pts
弝	bmb
弢	bsry
弨	bpdk
弪	bru
弪	brug
弶	bgy
弶	bgyx
弸	bvvy
弿	wqhb
彅	bhv
彅	bhvp
彐	bjj
彔	bks
彟	bkl
彟	bklr
彡	ess
彧	pdfe
彫	mgde
彿	wtf
徃	wls
徛	wmzk
徯	wyim
忄	hx
忞	vhx
忣	hcj
忨	hmp
忨	hmpe
忳	hfsc
忺	heq
怊	hpdk
怗	hydk
怞	hdy
怹	jehx
恇	hnn
恇	hnnw
恏	bhh
恏	bhhx
恓	hvx
恔	hab
恔	habi
恖	trbh
恟	hnbm
悆	jxhx
悈	hpl
悈	hplc
悕	hbn
悕	hbnr
悢	hiig
悰	hwf
悰	hwfs
悽	hfb
悽	hfbb
悾	heu
悾	heug
惇	hgh
惇	hghi
惎	zhhx
惓	hhhz
惔	hcc
惔	hcch
惗	hja
惗	hjah
惙	hrr
惙	hrrr
惛	hbo
惛	hbor
惢	hhh
惢	hhhx
惷	aioh
惼	hmi
惼	hmic
愃	hwff
愊	hfd
愊	hfdq
愐	hbm
愒	honf
愔	hxy
愬	hsvh
愭	hqo
愭	hqor
愽	hnk
愽	hnkc
慄	hve
慄	hvem
慆	hyp
慆	hypj
慇	zrh
慇	zrhx
慓	hvf
慓	hvfs
慜	ekhh
慠	hap
慠	haph
慥	hqd
慥	hqdu
慬	hld
慬	hlda
慭	ahm
慭	ahmh
慼	nyfh
慽	hny
慽	hnyy
憃	aiph
憇	azh
憇	azhx
憏	hhf
憏	hhfs
憕	hhzd
憙	hdhx
憭	hmhy
憯	hddo
憱	hgyo
憺	hxxs
懁	hyf
懁	hyft
懃	ldah
懆	hdde
懞	hlw
懞	hlwj
懽	hldu
戣	hfmp
戭	wfdp
扂	mydk
扅	mllx
扆	mti
扊	mcc
扊	mcch
扞	ueg
扠	urid
扤	ufp
扤	ufpe
扺	ubs
扽	ufs
扽	ufsc
抃	uzy
抃	uzyb
抆	uvw
抇	uor
抈	uvy
抏	ump
抏	umpe
抔	ucb
抙	uus
抦	ufmj
抶	uth
抶	uthf
拃	uwa
拏	brus
拤	uyfy
挊	uyfy
挓	uwtr
挜	ufcy
挦	ubk
挦	ubkc
挵	unl
挵	unlc
挼	uybn
捄	ufk
捄	ufki
捨	ujas
捯	uyp
捯	uypd
捵	uih
捵	uihb
捽	uzjn
掞	ucch
掯	usv
掯	usvy
掱	uuu
掱	uuus
掹	uha
掹	uham
揅	mflu
揌	uqh
揌	uqhx
揕	uzha
揢	uws
揢	uwsg
揦	uxpd
揳	uap
揳	uapm
揹	uav
揹	uavv
揻	unfb
揾	uoam
搇	ujat
搉	uwu
搉	uwui
搋	uxzh
搒	uiw
搒	uiwl
搕	ugka
搢	ufco
搥	utk
搥	utku
搰	ufg
搳	uwad
搾	uew
搾	uewa
摏	uaip
摛	uzb
摛	uzbv
摴	utma
摽	uvf
摽	uvfs
撖	uaq
撖	uaqh
撚	uvm
撚	uvmc
撴	ughh
擖	ulof
擩	utle
擿	uimu
攲	mzc
攲	mzci
攴	hpp
攵	hp
攷	fah
攷	fahp
攽	hphp
敁	ydhp
敔	wdh
敔	wdhp
敠	rrrh
敩	kwhh
斝	ddwj
斠	qfmj
斨	atj
斲	ctj
斶	tyn
斶	tync
斿	lehi
旂	letj
旐	lep
旐	lepw
旓	ley
旓	leyv
旞	lehu
旴	ofn
旴	ofns
旵	ovs
旸	oae
旸	oaes
旻	ovw
旿	oen
旿	oens
昄	oxry
昇	otlc
昈	omh
昉	olf
昍	oor
昒	ones
昚	mhor
昡	ozi
昡	oziy
昣	oje
昣	ojes
昤	ojk
昤	ojks
昪	okl
昪	oklc
昫	ogj
昰	ofs
昰	ofsi
昳	oth
昳	othf
昺	ofmj
昽	otl
晅	ofo
晅	ofof
晊	oyi
晐	okh
晙	okhh
晞	obnr
晢	uto
晢	utor
晪	oih
晪	oihb
晫	oyo
晫	oyon
晬	ozj
晬	ozjn
晱	occh
暅	ohff
暍	oonf
暎	olm
暎	olmm
暕	oxh
暕	oxhb
暱	onl
暱	onld
暲	oxn
暲	oxns
暵	old
暵	oldh
暶	ole
暶	olet
暿	ohd
暿	ohdk
曆	xxxo
曇	otb
曇	otby
曈	oidl
曌	ove
曌	oveu
曚	olw
曚	olwj
曱	sj
朅	gkof
朏	vsm
朏	vsmk
朒	vmjj
朓	vpw
朓	vpww
朘	vkhh
朣	vid
朣	vidl
朤	vvvv
朩	emm
朳	ehb
朸	esl
朿	emk
杄	elq
杇	ema
杇	emae
杕	emd
杙	epi
杧	efw
杴	eeq
杻	eagt
枅	efl
枅	eflc
枍	ehf
枍	ehfa
枑	efbj
枒	ely
枠	ekn
枠	ekns
枲	kde
枲	kdem
枹	env
枹	envs
柈	ehu
柈	ehus
柊	ehw
柊	ehwb
柖	epdk
柮	esm
柮	esmk
柷	edp
柷	edpe
柹	etf
柺	eds
柺	edsl
栃	exfp
栐	eik
栐	eiks
栒	eno
栒	enor
栘	ellx
栞	eeem
栟	ehl
栟	ehlc
栢	efu
栢	efub
栴	eemz
栻	epu
栻	epug
栿	ejm
栿	ejmq
桜	ekbn
桯	edn
桯	ednw
桲	enwh
桹	eiig
梌	ejx
梌	ejxh
梐	evvg
梠	eddk
梣	evja
梫	ebw
梫	ebwr
梴	ets
梴	etsu
梶	ecv
梶	ecvm
梼	eak
梼	eakc
梽	eghx
梾	eah
梾	eahb
梿	eyu
梿	eyuc
棁	ehd
棁	ehdp
棐	rem
棑	erf
棓	eidk
棤	elor
棨	mhe
棨	mhem
棪	ecch
棫	epdf
棬	ehhz
棻	lhpe
棽	eeja
椀	ewl
椀	ewlz
椆	emgd
椇	eqhb
椑	eut
椑	eutn
椓	eji
椓	ejid
椛	elj
椛	eljv
椥	eod
椥	eodk
椪	ehc
椪	ehcy
椸	ele
椸	elee
楒	eqhx
楙	eite
楢	ehyy
楩	ejf
楩	ejfb
楪	ela
楪	elae
楬	eon
楬	eonf
楯	exnq
榃	eeqt
榅	eoa
榅	eoam
榊	efog
榑	enkc
榖	gwfr
榰	eqor
榼	egka
榾	efg
槃	ire
槃	irem
槅	eng
槑	ded
槑	dede
槕	eyoe
槙	enqh
槚	evo
槚	evob
槜	euv
槜	euvn
槥	eaa
槥	eaab
槱	eych
槺	exb
槺	exbk
槻	ehej
樋	ektu
樛	ezje
樸	ecgi
橑	emh
橑	emhy
橞	enqh
橤	hhhe
橦	eidl
檇	eumk
檞	extq
檵	eiia
櫆	eaj
櫆	eajd
櫈	ehzo
櫌	ewhh
櫶	ewah
櫺	etdd
櫼	ejjf
欂	elk
欂	elkk
欛	ett
欛	ettv
欝	ebbk
欞	etdj
欬	keq
欸	koe
欸	koeq
欻	cce
欻	cceq
欿	xpeq
歅	vgeq
歔	zceq
歘	ccce
歠	rrre
殀	gtmd
殣	glda
殭	gfqf
殽	bnvr
毌	ku
毐	gku
毑	key
毪	vkq
毪	vkqn
毴	vrf
毷	oqv
毷	oqvm
氄	itmv
氇	vwo
氇	vwor
氉	dddv
氕	vtp
気	vbi
氶	aks
氹	aks
氼	kjr
氾	kzj
氿	kkj
汈	kafi
汋	knid
汍	kki
汍	kkid
汎	koid
汏	kmd
汖	vks
汧	kfl
汧	kflc
汫	kqj
汭	kmj
汭	kmjr
沄	kby
沇	kkp
沇	kkpe
沕	kne
沕	knes
沘	kvvb
沚	ksi
沝	kks
沢	kci
沢	kcid
沨	kobi
沴	kje
沴	kjes
沺	kqt
泂	kmdk
泃	kgj
泆	kthf
泇	ksd
泇	ksdk
泙	kehb
泚	ksv
泚	ksvb
泜	kbi
泜	kbid
洈	kxxz
洏	kle
洑	kjm
洑	kjmq
洓	kemk
洘	kqf
洘	kqfa
洢	kjbt
洣	kpm
洨	kab
洨	kabi
洩	koat
洭	knnw
洴	khl
洴	khlc
洸	kmg
洺	kldk
洿	kmma
浉	kpfr
浐	kix
浐	kixc
浕	kciw
浛	kja
浛	kjad
浟	kjg
浟	kjgh
浡	knwh
浤	kwnk
浥	kdmb
浬	kdl
浭	kfob
浰	kxp
浰	kxpd
浲	kha
浲	khaf
浵	kmz
浵	kmze
涄	kdf
涄	kdfa
涊	kpih
涍	kqh
涍	kqhi
涐	ktup
涘	kko
涘	kkos
涚	khd
涚	khdp
涢	kdo
涢	kdob
涴	kwl
涴	kwlz
淏	kofm
淒	kfb
淒	kfbb
淜	kvvy
淟	kih
淟	kihb
淯	kbvy
淴	kneh
淽	kls
淽	klsi
渋	ksw
渋	ksww
渟	kga
渟	kgad
渰	kjdl
渼	kgm
渼	kgmd
湉	khas
湑	ktv
湑	ktvy
湜	kot
湜	kots
湝	kvvu
湣	kdor
湪	kbj
湪	kbjs
湲	kyfr
湴	khc
湴	khcy
湻	kgo
湻	kgor
溁	klwe
溇	kpb
溇	kpbn
溍	kfc
溍	kfco
溚	kljd
溞	kric
溠	kgu
溠	kgug
溦	kvfh
溵	kzrs
溹	knwi
滀	kziq
滃	khkz
滆	kng
滈	kgg
滉	komg
滍	ksf
滍	ksfc
滘	kwhd
滙	knu
滙	knui
滧	kabh
滪	kiwy
滫	kjgv
滮	kze
滮	kzes
滷	kyr
滷	kyrp
漈	khf
漈	khfs
漋	kthl
漒	kbdc
漖	kqhh
漤	keeb
漦	ahxk
漴	kvwf
漷	kght
漹	kfsc
漻	kzje
漼	kvu
漼	kvui
潏	kit
潏	kitd
潖	knnm
潝	kjdz
潟	kpn
潟	kpnc
潩	kqlh
潵	klv
潵	klvh
潶	kph
潽	khco
潾	kpl
潾	kplv
澂	kvfh
澐	ktb
澐	ktby
澔	kuq
澔	kuqd
澛	kwor
澥	kxtq
澨	kruj
澪	ktjk
澭	kziu
澱	kcl
澱	kclr
澴	kyft
澼	kcd
澼	kcdn
澽	kzjs
濋	keet
濛	klwj
濩	klu
濩	klur
瀁	kgii
瀌	kxch
瀍	kxd
瀍	kxdg
瀔	kgwr
瀞	kavb
瀱	kyx
瀱	kyxp
瀺	kwvw
瀼	ktd
瀼	ktdf
瀽	kwqp
灈	kqqu
灕	kzbu
灧	kva
灧	kvam
灬	ch
灺	cey
炁	dch
炆	cvw
炌	cjpd
炟	cof
炟	cofi
炣	czk
炤	cpdk
炰	nvc
炰	nvch
烆	cpx
烔	cmf
烔	cmfd
烜	cfo
烜	cfof
烝	akfc
烠	cnvy
烱	cmhd
烶	ctgu
烺	ciig
烻	ctsu
烿	cmze
焆	cdv
焆	cdvy
焌	ckh
焌	ckhh
焗	cca
焗	ccad
焘	akch
焜	cov
焜	covv
焞	cghi
焠	czj
焠	czjn
焮	cteq
焿	cxb
焿	cxbj
煁	czha
煃	cmgg
煋	cols
煓	cvl
煓	cvle
煚	onnc
煟	cqv
煟	cqvy
煣	cit
煣	cite
煴	coa
煴	coam
煿	cnk
煿	cnkc
熇	cgg
熛	cvfs
熜	ctr
熜	ctrh
熥	cktu
熯	cld
熯	cldh
熺	chdk
熻	cjdz
熿	cnh
燄	xpc
燄	xpcc
燊	ccce
燋	cuc
燋	cuch
燏	citd
燐	cplv
燚	cccc
燬	cpur
燻	clp
燻	clph
爇	lghc
爊	cxc
爊	cxch
爔	cgx
爔	cgxp
爕	sccc
爚	cjdd
爟	cldu
爧	ctdj
爫	yaa
牁	azk
牂	agy
牚	sly
牜	qn
牣	qpi
牣	qpid
牤	qfw
牥	qlf
牪	qqn
牮	jpq
牮	jpqn
牴	qbi
牴	qbid
牷	qjn
牷	qjnw
牸	qwh
牸	qwhi
牻	qoe
牻	qoes
犇	qqq
犇	qqqn
犗	qwad
犨	uuq
犨	uuqn
犭	mqq
犮	nrid
犼	mhae
犽	mly
狉	mcf
狉	mcfi
狌	mls
狓	mrp
狖	mex
狛	mub
狝	mxy
狝	mxyx
狥	mno
狥	mnor
狨	mpn
狨	mpns
猂	moe
猂	moeg
猄	mgy
猄	mgyx
猇	mzh
猋	mmmq
猨	myf
猨	myfr
猯	mvl
猯	mvle
猰	map
猰	mapm
猺	mya
猺	myaf
獕	mvu
獕	mvui
獴	mlw
獴	mlwj
玃	mqqr
玍	egt
玏	nsl
玒	nug
玓	nnid
玕	neg
玗	nfn
玗	nfns
玘	nvj
玙	nfa
玙	nfaf
玚	nae
玚	naes
玞	nhf
玠	njpd
玡	nly
玤	naf
玥	nvy
玦	nnjr
玭	nvv
玭	nvvb
玱	njz
玱	njzj
玵	nzg
玶	nehb
玹	nzi
玹	nziy
玼	nsv
玼	nsvb
玽	ngj
玿	npdk
珅	nog
珅	nogs
珇	nfq
珋	nbm
珌	nht
珌	nhtp
珒	nbv
珕	nss
珕	nsss
珖	nmg
珛	nnvy
珝	nzv
珢	nig
珣	nno
珣	nnor
珦	ntmd
珨	njdk
珪	nggt
珫	nbp
珫	nbpe
珮	nof
珮	nofr
珰	nyb
珰	nybj
珵	ndn
珵	ndnw
珷	nfp
珷	nfps
珸	nwd
珸	nwdk
珹	nna
珹	nnae
珺	nbt
珺	nbtd
珽	ntg
珽	ntgu
琀	nja
琀	njad
琄	ndv
琄	ndvy
琇	nxv
琇	nxvn
琈	nyh
琈	nyhi
琍	nxp
琍	nxpd
琎	nqu
琎	nquc
琔	nwt
琔	nwts
琖	npp
琖	nppg
琞	ovn
琞	ovni
琟	nui
琡	nyfr
琤	nxbv
琫	nai
琫	naiu
琭	nbk
琭	nbks
琯	nwk
琯	nwki
琱	nmgd
琲	nrf
琹	nne
琹	nnem
瑀	ntdv
瑂	ncq
瑂	ncqm
瑃	naio
瑄	nwff
瑅	nots
瑆	nol
瑆	nols
瑊	nnfd
瑑	nbj
瑑	nbjs
瑓	nxh
瑓	nxhb
瑔	nuk
瑔	nuks
瑖	nuf
瑖	nufr
瑝	nun
瑝	nunw
瑢	nwhg
瑧	naix
瑨	nfc
瑨	nfco
瑬	kboi
瑱	nnq
瑱	nnqh
瑳	ngu
瑳	ngug
璆	nzje
璈	nap
璈	naph
璒	nhz
璒	nhzd
璘	npl
璘	nplv
璟	nogy
璠	ntpq
璥	nlg
璥	nlgh
璪	ndde
璬	nul
璬	nulh
璮	nzr
璮	nzrf
璱	nnnt
璲	nhj
璲	nhju
璿	nghq
瓀	ntle
瓈	nxpk
瓖	ntdf
瓘	nldu
瓧	rns
瓩	rlq
瓰	rhp
瓰	rhpd
瓸	rfu
瓸	rfub
瓻	bnrr
甃	xcr
甃	xcrw
甅	rxd
甅	rxdl
甗	znrw
甡	lls
甦	fobl
甪	tty
甴	dy
畇	qnwb
畊	qqj
畑	cqt
畖	qyg
畠	uqt
畤	qgkc
畬	jxq
畬	jxqt
畯	qkhh
畺	fqf
畺	fqff
疁	qzj
疁	qzje
疌	fbsi
疍	tofi
疐	nwq
疐	nwqt
疒	abb
疘	aug
疢	ach
疭	ajjr
疻	adhb
痁	ayd
痁	aydk
痃	azi
痃	aziy
痄	awa
痎	akh
痏	anvy
痐	ard
痐	ardk
痓	ayi
痠	akhh
痺	autn
痾	atz
痾	atzk
瘄	alor
瘆	akme
瘈	aapm
瘝	ayk
瘝	ayks
瘭	avf
瘭	avfs
癒	ajv
癒	ajvh
癗	atq
癗	atqt
癥	awv
癥	awvh
癿	uae
皁	uns
皃	upe
皕	fuf
皕	fufu
皛	uuub
皝	unm
皝	unmg
皞	uum
皞	uumn
皦	uul
皦	uulh
皭	uyyk
盉	xam
盝	bka
盝	bkam
盦	jay
盦	jaya
盩	ggha
盷	qnwb
盻	qhfa
眊	qvm
眜	qfe
眜	qfem
眥	svq
眥	svqm
眰	qyi
睄	qyv
睄	qyvy
睆	qwm
睆	qwmp
睎	qbnr
睏	qre
睏	qrem
睒	qcch
睖	qghh
睩	qbk
睩	qbks
睺	qjno
瞇	qpuc
瞫	qvo
瞫	qvon
矇	qlw
矇	qlwj
矞	itmd
矰	ohro
矱	olu
矱	olur
矴	mad
矻	mea
矻	meai
矼	mug
砄	mnj
砄	mnjr
砆	mhf
砠	mfq
砢	mzk
砫	min
砫	minw
砮	brms
砯	mik
砯	miks
砳	mms
砵	mef
砵	mefi
硁	mru
硁	mrug
硃	mta
硃	mtaw
硊	mxxz
硋	mkh
硍	mig
硔	mlh
硔	mlhb
硙	mvvj
硚	mtm
硚	mtmp
硠	miig
硵	myr
硵	myrb
硿	meu
硿	meug
碁	zhm
碁	zhms
碃	mavy
碈	mbor
碏	mlor
碥	mmi
碥	mmic
碨	mqft
碶	mapm
磈	mag
磎	myi
磎	myim
磏	mhbc
磜	mhfs
磡	mzhs
磹	mvo
磹	mvon
磻	mtp
磻	mtpq
礃	msu
礃	msus
礌	mtq
礌	mtqt
礞	mlwj
礤	mlhf
礳	mzm
礳	mzms
礵	mte
礵	mteq
礻	fss
祂	fey
祃	fnm
祊	flf
祋	frs
祎	fgw
祏	fms
祲	fbw
祲	fbwr
祼	fqem
祾	fgh
祾	fghh
禋	fvg
禋	fvgt
禒	fbj
禒	fbjs
禔	fot
禔	fots
禘	fi
禘	fiw
禘	fiwr
禚	fgc
禚	fgch
禛	fnq
禛	fnqh
禟	fxb
禟	fxbd
禤	fyz
禤	fyzv
禥	fzhg
禦	wazf
禩	fql
禩	fqlh
禵	fotw
禸	vrr
禿	xpe
秬	xnn
秬	xnnk
秾	xwt
秾	xwti
稃	xyh
稃	xyhi
稌	xjx
稌	xjxh
稑	xghg
稙	xnqf
穀	gwfr
穄	xhfs
穙	xcg
穙	xcgi
穜	xidl
穟	xhj
穟	xhju
窅	eqm
窊	eyg
窎	exn
窾	egf
窾	egfe
竍	ins
竏	ilq
竓	ivm
竕	ihpd
竘	igj
竡	ifu
竡	ifub
竫	ixbv
竰	ixdl
笘	rydk
笭	rjks
笯	rbr
笯	rbry
笹	rla
笹	rlae
筀	rggt
筜	ryb
筜	rybj
筤	rii
筤	riig
筥	rddk
筦	rwm
筦	rwmp
筭	rnl
筭	rnlc
筶	rqd
筶	rqdk
筼	rdob
箑	rfb
箑	rfbs
箒	rbw
箒	rbwr
箖	ree
箖	reem
箙	rvz
箙	rvzr
篅	rvle
篛	rbww
篠	rjge
篨	rtj
篨	rtjx
簃	rxll
簉	rqdu
簑	rtd
簑	rtdf
簕	rtsl
簖	rpa
簖	rpat
簝	rmhy
簠	rna
簠	rnam
簰	rau
簰	raun
簷	rxxs
籐	rvh
籐	rvhk
籝	rfdi
籤	rjj
籤	rjjf
籥	rjdd
籧	rzj
籧	rzju
籰	rqq
籰	rqqr
籹	pbn
籺	pea
籺	peai
籾	ppi
籾	ppid
粃	pvvb
粄	pxr
粄	pxry
粔	pnnk
粿	pqem
糄	pmic
糒	plt
糒	pltt
糵	ltkp
紬	idy
絜	api
絜	apis
縠	gwfr
縢	vhhi
繄	nori
纍	qqqi
纟	is
纮	inks
纴	itgs
纻	iwfi
纼	ibg
纼	ibgs
绖	iyi
绤	ihg
绹	inaf
缊	ioa
缊	ioam
缐	iuk
缐	iuks
缞	itd
缞	itdf
罇	ahy
罇	ahyk
罉	asu
罉	asus
罍	qqqa
罒	yss
罥	ydv
罥	ydvy
罦	yyh
罦	yyhi
罳	yqhx
罶	ybq
罶	ybqt
罽	yxc
罽	yxcp
羑	gxid
羓	gmb
羕	gik
羕	giks
羖	grs
羨	gke
羨	gkeq
羱	gxuy
羴	gggy
羶	gzrf
翂	zhp
翂	zhpd
翃	nkz
翃	nkzv
翈	szv
翋	zil
翙	vlz
翙	vlzv
翚	zwyc
翛	jghz
翫	zum
翫	zump
翯	zgg
翷	plvz
翾	yfdz
耂	ql
耇	qgj
耈	qgj
耏	les
耑	vle
耖	ayt
耖	aytp
耢	alws
耤	alor
耥	ass
耰	awh
耰	awhh
耲	atyk
肏	jmj
肏	jmjj
肶	vvvb
肸	vhn
肸	vhns
胈	vnr
胈	vnri
胔	svmj
胠	vgks
胣	vee
胣	veey
胷	nbmv
胾	npm
胾	npmj
脃	vxm
脃	vxmb
脎	vbe
脎	vbem
脝	vgrl
脟	vyk
脟	vykc
脢	vek
脢	vekm
脦	vph
脦	vphx
脩	jghv
脰	vzd
脶	vdmj
脷	vxp
脷	vxpd
脿	vat
脿	vati
腒	vccg
腘	vrn
腘	vrni
腙	vwfs
腨	vvle
腯	vxnq
膇	vtk
膇	vtku
膍	vtr
膍	vtrv
膗	vvui
膙	vbd
膙	vbdc
膥	anaj
膪	viwd
膰	vtpq
膵	vlzn
臋	clhj
臑	vtle
臘	vop
臘	vops
臜	vqpo
臝	fdvi
臞	vqqu
臺	gdwy
臽	xpj
臿	lpj
舠	ipd
舥	imb
舲	ijk
舲	ijks
艃	idl
艅	ijx
艅	ijxh
艎	iun
艎	iunw
艷	vaam
芃	loi
芃	loid
芔	slc
芠	lvw
芣	lcb
芲	ljl
芶	lnk
芶	lnks
芼	lvm
苉	lnpe
苠	ldm
苢	lki
苧	lwad
苲	lwa
苶	ljy
苶	ljyx
苽	lyg
苾	lhtp
茀	ltf
茋	lbid
茓	lex
茝	lqc
茢	lgp
茢	lgpd
茩	lxfd
茻	llc
茽	ljdg
荁	lfof
荄	lkh
荍	lih
荍	lihp
荓	lhl
荓	lhlc
荖	lql
荙	lmuc
荮	lik
荮	likc
荳	lzd
莙	lbt
莙	lbtd
莝	ljjg
莰	lgeq
莶	ljkf
莿	lemp
菂	luni
菈	luil
菉	lbks
菍	ljah
菑	loqt
菓	lqem
菥	letj
菼	lcch
萂	lxd
萂	lxdk
萚	luru
萣	lwts
萩	lxc
萩	lxch
萳	lnm
萳	lnmg
萹	lmi
萹	lmic
葓	lkl
葓	lklh
葖	lemq
葙	leqm
葰	ljkh
葴	lnfd
蒄	lwmk
蒈	lvvu
蒎	lkx
蒎	lkxt
蒐	lag
蒗	lkii
蒟	ligj
蒨	ljav
蒱	lunf
蒻	lbw
蒻	lbww
蓂	lwo
蓂	lwoa
蓆	lxlr
蓇	lfg
蓏	lyy
蓏	lyyg
蓢	liiv
蓣	liwy
蓨	ljgv
蓳	llda
蓺	lghi
蔀	lidt
蔃	lbdc
蔈	lvf
蔈	lvfs
蔊	lcoe
蔔	lnfq
蔧	laa
蔧	laab
蔹	ljkh
蕓	ltby
蕗	lps
蕗	lpsg
蕰	lko
蕰	lkoa
蕲	lhq
蕲	lhqt
薁	ltmm
薙	lou
薙	loui
薢	lxt
薢	lxtq
薳	lgdu
薸	lkv
薸	lkvf
薿	lvot
藂	lqr
藂	lqrk
藊	lxm
藊	lxmi
藟	lqqq
藠	luu
藠	luuu
藥	luie
藦	lzu
藦	lzus
藨	lxch
蘘	ltdf
虍	zh
虒	xzh
虓	kzh
虡	zchb
虤	zzh
虷	ceg
虸	chi
蚃	icc
蚄	clf
蚆	cmb
蚡	chpd
蚲	ceh
蚲	cehb
蛃	cfmj
蜎	cdvy
蜐	cgks
蝂	cax
蝂	caxr
蝄	cmhf
蝘	cno
蝘	cnob
蝡	clmd
蝨	anc
蝨	ancc
蝯	cyf
蝯	cyfr
蝲	cxpd
螀	alkc
螗	cxbd
螠	cka
螠	ckam
螣	vhhc
螱	cfkc
蟇	lomc
蟏	clb
蟏	clbh
蟢	chdk
蟫	cvo
蟫	cvon
蠋	cyn
蠋	cync
蠔	cgj
蠔	cgjs
衂	tap
衂	tapi
衃	tac
衃	tacb
衊	tal
衊	tali
衎	peg
衒	pzi
衒	pziy
衕	pmfd
衖	plhb
衚	pcvy
衠	pnq
衠	pnqh
衤	tii
衹	tbs
衺	tly
袆	tgw
袗	tje
袗	tjes
袪	tgks
袯	tsr
袯	tsri
袴	tmma
袺	tgd
袺	tgdk
袿	tggt
裇	tta
裇	ttam
裈	twyc
裋	tzd
裌	tmjj
裑	tzs
裛	tdm
裛	tdmb
裻	yfyt
褀	tzh
褀	tzhb
褎	tux
褎	tuxh
褏	tud
褏	tudy
褕	tjvp
褝	tkq
褝	tkqn
褟	toz
褟	tozv
褦	tkv
褦	tkvv
褯	txl
褯	txlr
襆	tcg
襆	tcgi
襈	tvvh
襕	tax
襕	taxh
襚	thju
襜	txx
襜	txxs
襫	tmf
襫	tmfu
襶	tnph
覇	vtv
覇	vtvy
觃	ehi
觍	ihej
觕	qxt
觕	qxty
觟	xtgg
觭	xtmz
觱	nfdt
觿	xtv
觿	xtvd
訄	ksy
訚	asy
詟	tsy
詧	hsy
諐	jdos
謷	aphs
讠	syy
讱	spi
讱	spid
讻	sbm
讻	sbmk
诇	smd
诇	smdk
诐	srp
诪	sak
诪	sakc
谞	stv
谞	stvy
谼	hlh
谼	hlhb
谿	yimh
豗	fpj
豗	fpjs
豙	ijs
豨	jbnr
豭	jcmr
豮	jnlo
貆	mfof
貍	mdl
赑	ooob
赒	omgd
赗	ooq
赗	ooqm
赟	vfpo
赩	gcx
赩	gcxm
赪	gcy
赪	gcyo
赯	gcxd
赲	psl
赸	pvs
趖	pjjg
趯	pzu
趯	pzui
跂	pci
跅	pti
跅	ptid
跐	psv
跐	psvb
跩	poa
跩	poat
跰	phl
跰	phlc
跱	pgk
跱	pgkc
跼	pca
跼	pcad
踒	pxbn
踖	plo
踖	plor
踦	pmz
踦	pmzk
踧	pyf
踧	pyfr
踳	paio
踶	pot
踶	pots
蹅	peof
蹍	pcl
蹍	pclt
蹐	pwwv
蹓	pbq
蹓	pbqt
蹜	pwj
蹜	pwju
蹢	pim
蹢	pimc
蹽	pmh
蹽	pmhy
蹾	pgh
蹾	pghh
躃	pcd
躃	pcdn
躄	cdnp
躶	zqem
躾	zgmd
轪	ymd
轷	ythn
辀	yio
辌	ygy
辌	ygyx
辒	yoa
辒	yoam
辡	nnx
辢	xnx
辶	uc
辻	nuc
込	juc
辿	vuc
迌	vuc
迍	fsu
迍	fsuc
迒	zou
迒	zouc
迴	rduc
迺	vuc
逴	yonu
遆	iwru
遝	yku
遝	ykuc
遹	itmu
邅	zrdu
邘	fnt
邘	fnte
邠	hpt
邠	hpte
邲	htt
邲	htte
邽	ggte
邿	gkte
郈	xfdt
郚	wdt
郚	wdte
郤	hte
郪	fbbt
郿	cqte
鄀	lndt
鄃	jvpt
鄅	tdvt
鄋	pgrt
鄌	xbdt
鄑	fcot
鄗	gte
鄘	xbtt
鄚	lomt
鄜	xte
鄠	tmat
鄫	hryt
酂	qpqt
酅	vumt
酏	yey
酕	yvm
酦	ysr
酦	ysri
酺	ynf
醁	ybk
醁	ybks
醃	ymoa
醄	yna
醄	ynaf
醆	ypp
醆	yppg
醊	yrrr
醌	yovv
醡	yew
醡	yewa
醨	yzb
醨	yzbv
醽	ytd
醽	ytdd
醾	yzp
醾	yzpm
釆	tpm
釐	ahxd
鋬	uxrz
鍳	qrz
鍳	qrzj
鏇	zlet
鑒	qryz
钆	zae
钖	zaes
钘	zfl
钘	zflc
钷	znd
钷	zndk
铏	zflp
铓	zlfw
铕	znv
铕	znvy
铚	zyi
铥	ztgk
铦	zas
铷	zbdk
铹	zlw
铹	zlws
铻	zwd
铻	zwdk
铽	zphx
锧	zxno
锳	zlm
锳	zlmm
锽	zun
锽	zunw
镃	zhii
镈	znkc
镋	zsp
镋	zspe
镚	zvvv
镠	zzje
镤	zcgi
镮	zyft
镴	zops
镵	zwvw
闬	aeg
阇	aqo
阇	aqor
阓	aco
阓	acob
阘	aoz
阘	aozv
阛	ayf
阛	ayft
阝	te
阧	tjd
阰	tvvb
陁	teey
陎	ttaw
陏	tnvy
陑	tle
陞	ttlg
陻	tvg
陻	tvgt
隃	tjvp
隩	ttmm
隺	wui
雊	gui
雋	umk
雫	tfy
雫	tfyb
雰	thp
雰	thpd
霂	tke
霂	tkem
霅	tsy
霊	tff
霊	tffc
霑	tkyd
霙	tlm
霙	tlmm
霡	tvi
霡	tvik
霨	tcf
霨	tcfk
靉	tbyh
靘	avxm
靬	teg
靰	tfpe
靸	tcj
靺	tfem
靽	thus
靿	tisl
鞁	trp
鞌	wbt
鞌	wbtg
鞓	tdnw
鞚	teu
鞚	teug
鞝	tss
鞞	tutn
鞡	tuil
鞥	tjdl
鞦	txc
鞦	txch
鞧	thy
鞧	thyy
鞨	tonf
鞬	tbu
鞬	tbuy
鞮	tot
鞮	tots
鞳	tljd
韁	tfqf
韂	txxs
韆	tvm
韆	tvmu
韨	gnri
颋	tguw
颙	qvw
颙	qvwy
颣	piwy
飏	oba
飏	obae
飐	obyd
飔	obqh
飖	yao
飖	yaob
飗	obb
飗	obbq
飢	qoj
飤	qjr
飱	gqs
饑	qii
饑	qiii
饣	qss
饤	qad
饦	qtrq
饳	qsm
饳	qsmk
饸	qjd
饸	qjdk
饹	qsg
饻	qti
饾	qzd
馂	qkhh
馉	qfg
馌	qgka
馎	qnk
馎	qnkc
馚	xohp
馝	xoht
馞	xon
馞	xonh
馧	xoo
馧	xooa
驲	nor
骃	nrm
骃	nrmd
骉	nnn
骉	nnnm
骎	nbw
骎	nbwr
骕	nbph
骙	nhfm
骦	nte
骦	nteq
骭	feg
骺	fxf
骺	fxfd
骾	ffo
骾	ffob
髃	fqv
髃	fqvr
髈	fiwl
髎	fzj
髎	fzje
髢	peey
髽	pejg
鬁	pexp
鬌	penv
鬍	pec
鬍	pecv
鬎	pexp
鬐	peq
鬐	peqo
鬒	penh
鬘	peor
鬚	peew
鬦	jjd
鬰	ebbe
鬱	eaee
鬴	nnf
鬶	heng
鬷	nbmh
鬽	aes
魆	anu
魋	aui
鱽	wpd
鱾	wvj
鲉	wdy
鲊	wwa
鲌	wub
鲏	wrp
鲖	wmf
鲖	wmfd
鲗	wop
鲗	wopd
鲘	wxf
鲘	wxfd
鲙	wjb
鲙	wjby
鲝	gwv
鲪	wbtd
鲬	wkt
鲬	wkty
鲯	wzh
鲯	wzhb
鲴	wrc
鲴	wrcg
鲹	wkm
鲹	wkme
鲺	wat
鲺	watc
鲾	wfdq
鲿	wsb
鲿	wsby
鳀	wots
鳁	woam
鳂	wqf
鳂	wqft
鳈	wuk
鳈	wuks
鳉	wal
鳉	walk
鳋	wri
鳋	wric
鳑	wiw
鳑	wiwl
鳒	whbc
鳓	wts
鳓	wtsl
鳛	wzu
鳛	wzub
鳠	wlu
鳠	wlur
鳡	wnfh
鳣	wzr
鳣	wzrf
鳤	wrw
鳤	wrwk
鸤	cxn
鸧	jzx
鸧	jzxn
鸮	dfax
鸰	jkx
鸰	jkxn
鸴	kwx
鸴	kwxn
鸻	pxn
鸼	ixn
鹀	ujjx
鹍	ovvx
鹐	xpx
鹐	xpxn
鹒	xbjx
鹓	wlzx
鹔	bphx
鹖	onfx
鹙	xcx
鹙	xcxn
鹝	nxn
鹟	hkzx
鹠	bqx
鹠	bqxn
鹡	wwjx
鹢	kaxn
鹥	norx
鹯	zrdx
鹲	lwfx
鹴	teqx
鹵	yrpm
麀	xvb
麑	xppe
麖	xgyx
麤	xxxl
麵	ejjb
麹	ahn
麹	ahnp
麿	zddk
黁	zxo
黁	zxor
黇	nydk
黐	xjkv
黡	xmp
黡	xmph
黵	pxxs
鼒	ntq
鼒	ntqa
鼟	hch
鼟	hchz
鼥	pnri
鼧	pwvb
鼩	pgj
鼫	pms
鼽	oqlk
齁	oqlg
齆	oqlm
齇	oqlf
齉	oqlt
龁	lea
龁	leai
龂	ltj
龵	us
鿃	qmj
鿃	qmjj
鿍	ghv
鿍	ghvk
鿎	mmu
鿎	mmuc
鿏	zahi
鿔	zzzk
鿫	vtmm
鿬	mqt
鿭	zxy
鿭	zxyx
鿽	ewa
𠀾	cjby
𠂉	et
𠃓	aes
𠄏	rll
𠅤	zqhx
𠇔	jvm
𠉂	jmu
𠉂	jmuc
𠊎	jxg
𠊎	jxgg
𠍐	jkm
𠍐	jkmy
𠙶	rmk
𠡦	lssu
𠧚	yrj
𠧚	yrjr
𠩃	smx
𠩃	smxc
𠬶	bwry
𠮛	fdk
𠰴	dms
𠲎	djp
𠲎	djpg
𠲖	dti
𠳐	dat
𠳐	date
𠵆	duof
𠷡	fuj
𠷡	fujd
𡆠	rai
𡌶	ghc
𡌶	ghcy
𡍷	ghff
𡎚	gmi
𡎚	gmic
𡏋	kngt
𡐓	gxbk
𡒄	gzrf
𡕩	trbh
𡗜	mhb
𡘙	mmmd
𡚦	bid
𡚽	agb
𡚽	agbn
𡛟	bnu
𡛰	bdhb
𡝗	bbt
𡝗	bbtd
𡥆	aghi
𡦀	hao
𡦀	haov
𡮐	yyyy
𡰦	cjr
𡶦	vtfi
𡷫	vna
𡷫	vnae
𡺎	vwj
𡺎	vwjw
𢀖	rug
𢒉	efq
𢖿	yhx
𢘑	fdg
𢘑	fdgh
𢙐	hwt
𢙐	hwti
𢪒	uus
𢪘	hpu
𢪘	hpus
𢫬	ube
𢫬	ubem
𢱉	ucf
𢱉	ucfs
𣐿	eti
𣗋	esp
𣗋	espe
𣨼	glw
𣨼	glwr
𣬂	vveg
𣭲	ktvm
𣱼	kpd
𣱾	krl
𣲗	kgw
𣲘	kdu
𣵦	knqt
𣸣	knl
𣸣	knlo
𣸤	kyl
𣸤	kylf
𤆬	vch
𤌙	coz
𤌙	cozv
𤘧	qqn
𤙖	jdq
𤙖	jdqn
𤛭	qqqq
𤞤	mfc
𤞤	mfcx
𤞶	mwhe
𤧛	niw
𤧛	niwr
𤩽	nnmm
𤪌	nzhi
𤫉	nsc
𤫉	nscr
𤭢	zjjr
𤯔	fls
𤯥	bdls
𤯦	tpl
𤯦	tpls
𤱙	qef
𤱙	qefi
𤲶	qsq
𤲶	qsqs
𤺥	arj
𤺥	arjd
𤾩	fufu
𥄨	qag
𥄨	qagt
𥇢	qytj
𥉳	qbqt
𥔲	mdd
𥔲	mdda
𥕢	mfy
𥕢	mfyo
𥖄	mgw
𥖄	mgwe
𥖨	mdde
𥤶	evq
𥥷	ezd
𥧔	evp
𥧔	evpm
𥮾	rkm
𥮾	rkme
𥯨	rqh
𥯨	rqhx
𥻗	peof
𦈖	ioz
𦈖	iozv
𦈠	iyu
𦈠	iyuh
𦈡	itle
𦊞	mbbd
𦏴	zfn
𦏴	zfns
𦒍	idz
𦒍	idzv
𦒹	qal
𦙶	vcg
𦛨	vlws
𦝼	vpbn
𦠿	vfm
𦠿	vfmf
𦨩	itl
𦭜	ldh
𦭜	ldhb
𦰏	lhe
𦰏	lhem
𦰡	laut
𧊅	cds
𧊅	cdsl
𧋡	cra
𧋡	crag
𧋱	cqs
𧋱	cqsl
𧏾	nlnc
𧒽	ctq
𧒽	ctqt
𧗩	cpx
𧝁	tyz
𧝁	tyzv
𧟄	ttd
𧟄	ttdf
𧿹	pkm
𨃅	puf
𨃅	pufa
𨐈	ymg
𨓈	bduc
𨙸	cte
𨚕	klt
𨚕	klte
𨛍	yvt
𨛍	yvte
𨟠	qqut
𨭉	vfpz
𨰻	zzzz
𨱇	zfk
𨱇	zfki
𨱍	ziit
𨱏	zlj
𨱏	zljd
𨱑	znh
𨱔	zhy
𨱔	zhyk
𨺙	tppe
𨻧	tbq
𨻧	tbqt
𩉜	toj
𩠍	qle
𩠍	qlet
𩫇	cgg
𩽾	wwb
𩽾	wwbn
𩾃	wwpe
𩾌	wxbk
𪉈	svxn
𪎊	ahyt
𪚥	tttt
𪞝	wrus
𪟝	aosl
𪟧	qsqs
𪠽	dybj
𪣝	gur
𪣝	gurq
𪣻	gpb
𪣻	gpbn
𪤗	gzj
𪤗	gzje
𪥰	bwa
𪥰	bwad
𪨇	fpco
𪨊	cjj
𪨊	cjjr
𪨗	cwt
𪨗	cwtp
𪨰	vyq
𪨶	vmy
𪨶	vmyc
𪩘	vnmm
𪯡	dgv
𪯡	dgvw
𪻐	njjr
𪾔	ewam
𪾢	qej
𪿖	mzi
𪿖	mziy
𫁡	ixn
𫄤	imu
𫄤	imuc
𫄥	ifv
𫄥	ifvv
𫄧	its
𫄧	itsu
𫄶	ibd
𫄶	ibdc
𫄷	ixh
𫄷	ixhx
𫄸	ilp
𫄸	ilph
𫇭	lis
𫇭	lisi
𫉁	lywr
𫉄	lsq
𫉄	lsqo
𫊻	cbk
𫊻	cbkc
𫌀	taob
𫌨	xye
𫌨	xyej
𫍙	sey
𫍟	see
𫍟	seey
𫍢	spf
𫍢	spfp
𫍣	smfd
𫍯	snfd
𫍲	spg
𫍲	spgr
𫍽	syft
𫐄	yfp
𫐄	yfpe
𫐐	yppe
𫐓	yit
𫐓	yite
𫑡	dte
𫓧	zhf
𫓩	zjjr
𫓯	zggt
𫓶	zdv
𫓶	zdvy
𫓹	zzhb
𫔍	ztp
𫔍	ztpq
𫔎	zit
𫔎	zitd
𫔶	aoe
𫔶	aoem
𫖃	bco
𫖃	bcob
𫖔	glt
𫖔	gltt
𫖘	xkl
𫖘	xklc
𫖮	vvw
𫖮	vvwy
𫖯	pwww
𫖳	btdw
𫖹	nyfw
𫗧	qxs
𫗫	qcv
𫗫	qcvy
𫗰	qtk
𫗰	qtku
𫗴	qzr
𫗴	qzrf
𫘜	nvw
𫘝	nnjr
𫘤	nko
𫘤	nkos
𫘦	nnaf
𫘧	nbks
𫘨	nots
𫘪	nxu
𫘪	nxuy
𫘬	nyi
𫘬	nyim
𫚒	wtf
𫚔	wrdk
𫚕	wpf
𫚕	wpfr
𫚖	svw
𫚖	svwv
𫚭	wops
𫛞	xnj
𫛞	xnjr
𫛩	wbx
𫛩	wbxn
𫛭	mnx
𫛭	mnxn
𫛶	xsx
𫛶	xsxn
𫜨	lmb
𫜩	apl
𫜩	aplc
𫝭	boob
𫞩	nlml
𫟅	igy
𫟅	igyx
𫟦	yhj
𫟦	yhju
𫟹	zlh
𫟹	zlhb
𫟼	zmu
𫟼	zmuc
𫠊	nziy
𫠜	lpp
𫠜	lppe
𫠡	fjg
𫠡	fjgs
𫠣	ryx
𫢸	jhq
𫢸	jhqn
𫣊	jyw
𫣊	jywr
𫧯	ydm
𫧯	ydmj
𫩛	djjr
𫪁	dahb
𫪘	dnbe
𫫇	dfch
𫭟	gnb
𫭟	gnbi
𫭢	gjl
𫭪	gpf
𫭪	gpfp
𫭼	glws
𫮃	ghqn
𫯝	yff
𫯝	yffm
𫰛	brug
𫰡	bjvn
𫰰	bjkf
𫲦	hhdp
𫵘	chtp
𫵷	vxs
𫵷	vxsl
𫵼	vfob
𫶇	vlwr
𫷷	xze
𫷷	xzeq
𫸩	bnbi
𫼝	uxbj
𬀩	ogw
𬀪	oej
𬂁	vbt
𬂁	vbtd
𬂉	vhho
𬂩	ehh
𬂩	ehhb
𬃊	exno
𬆮	gwfr
𬇕	kfpd
𬇙	kob
𬇞	kfmj
𬇹	krn
𬇹	krni
𬉼	cnb
𬉼	cnbi
𬊈	cbkc
𬊤	chqn
𬊶	cpr
𬊶	cpra
𬌗	ljdk
𬍛	nby
𬍛	nbyx
𬍡	kaei
𬍤	nbkc
𬎆	nlw
𬎆	nlwi
𬑗	qaor
𬒈	kwms
𬒔	msv
𬒔	msvy
𬒗	mpr
𬒗	mpre
𬕂	ruob
𬖋	pai
𬖞	pok
𬖞	pokc
𬘓	ioc
𬘘	iwp
𬘘	iwpe
𬘡	irmd
𬘢	img
𬘩	itgu
𬘫	iwm
𬘫	iwmp
𬘬	iavy
𬘭	iee
𬘭	ieem
𬘯	ighi
𬘵	ihff
𬙂	iwfh
𬙆	itpq
𬙊	ipgt
𬙋	itdf
𬜬	lad
𬜬	ladk
𬜯	lml
𬞟	lssw
𬟁	lnxn
𬟽	cryx
𬢊	afde
𬢋	pwwe
𬣀	pgs
𬣀	pgsy
𬣙	sfn
𬣙	sfns
𬣞	swfi
𬣡	sfp
𬣡	sfpg
𬣳	sig
𬤇	svg
𬤇	svgt
𬤊	sot
𬤊	sots
𬤝	snq
𬤝	snqh
𬤨	sdde
𬧀	pal
𬧀	palk
𬨂	ybs
𬨎	yhy
𬨎	yhyy
𬩽	bkte
𬪍	bote
𬪩	ywt
𬪩	ywti
𬬩	zpi
𬬫	zvvb
𬬭	zjl
𬬮	zpc
𬬰	zjz
𬬰	zjzj
𬬱	ztj
𬬸	zei
𬬸	zeid
𬬹	zog
𬬹	zogs
𬬺	zfq
𬬻	zyc
𬬻	zycs
𬬿	zpdk
𬭁	zkm
𬭊	zeg
𬭊	zegt
𬭍	zoeg
𬭎	zwn
𬭎	zwnk
𬭚	zghi
𬭛	zkr
𬭛	zkrp
𬭣	zuk
𬭣	zuks
𬭤	zjno
𬭨	ztku
𬭩	zhk
𬭩	zhkz
𬭬	zaa
𬭬	zaab
𬭯	zfh
𬭯	zfhp
𬭳	zhdk
𬭶	zph
𬭸	zpl
𬭸	zplv
𬭼	zhj
𬭼	zhju
𬮤	ajdk
𬮱	avg
𬮱	avgt
𬮴	axy
𬮿	tvvj
𬯀	tqq
𬯎	tcob
𬱖	dwy
𬱟	xxzw
𬲱	qwv
𬲱	qwvb
𬲽	qzh
𬲽	qzhb
𬳇	qwf
𬳇	qwff
𬳵	ncf
𬳵	ncfi
𬳶	nmdk
𬳽	nqpe
𬳿	njx
𬳿	njxh
𬴂	nrf
𬴃	nam
𬴃	nams
𬴊	nplv
𬶋	wgj
𬶍	wwv
𬶍	wwvb
𬶏	wxx
𬶏	wxxz
𬶐	wpw
𬶐	wpww
𬶟	wxp
𬶟	wxpd
𬶠	wxhb
𬶨	idw
𬶨	idwv
𬶭	whfs
𬶮	whd
𬶮	whdk
𬷕	nxn
𬸅	xbx
𬸅	xbxn
𬸘	nobx
𬸚	msmx
𬸣	wqhx
𬸦	leox
𬸪	tpqx
𬹼	ljpd
𬺈	lmzk
𬺓	leet
𭄹	isq
𭄹	isqs
𭎂	gjj
𭎂	gjjr
𭑵	isb
𭑵	isbn
𭚦	bxg
𭣇	unq
𭣇	unqw
𭱊	kuw
𭱊	kuwy
𮆏	rax
𮆏	raxh
𮉧	iml
𮉨	idmj
𮉪	iqr
𮉪	iqry
𮉫	ixbn
𮉬	izjn
𮉯	ihf
𮉯	ihfs
𮐨	loob
𮔂	clz
𮔂	clzj
𮔅	cxo
𮔅	cxob
𮔊	cml
𮖱	tgdw
𮙊	stx
𮙊	stxh
𮙋	snas
𮝴	yyg
𮝵	yle
𮝹	yyf
𮝹	yyft
𮣲	zug
𮣳	znks
𮣴	zts
𮣴	ztsu
𮤲	aht
𮤲	ahtp
𮧴	gpc
𮧵	gjv
𮧵	gjvn
𮩝	qon
𮩝	qonf
𮩞	qgw
𮩞	qgwz
𮪥	nghh
𮬝	wvl
𮬝	wvlx
𮬡	wfg
𮭦	vjax
𮭨	owbx
𮯙	lzk
𮰃	jge
𮰃	jgey
𮱡	yhi
𮳺	qnm
𮷛	yyyc
𮸽	cccf
𮹝	ttt
𮹝	tttl
𰁸	jybj
𰂎	javy
𰃷	wjzj
𰇣	drp
𰇣	drpg
𰌀	lwbn
𰌂	byo
𰌂	byob
𰞇	crus
𰟘	caxp
𰡘	mjao
𰣊	qsn
𰣊	qsnr
𰨖	fotw
𰪿	plw
𰪿	plws
𰬪	ikm
𰬪	ikme
𰯼	pmfo
𰵝	sxh
𰵞	sik
𰵞	siks
𰵤	ssg
𰵦	sab
𰵦	sabi
𰵧	sghx
𰵩	snf
𰵴	syfr
𰵼	slv
𰵼	slve
𰷥	wfob
𰹲	ydk
𰻝	esi
𰻝	esiu
𰽗	zfns
𰽚	zxg
𰽴	zmm
𰽴	zmma
𰽼	zhl
𰽼	zhlc
𰽽	zgy
𰾫	zpra
𱁬	tbtt
𱂨	wbw
𱂨	wbwy
𱂩	nwy
𱂱	nfdw
𱃱	qea
𱃱	qeai
𱃺	qas
𱅋	nqe
𱇑	wfr
𱇑	wfrj
𱇒	wvvb
𱇣	wsr
𱇣	wsri
𱇫	bdw
𱇫	bdwv
𱇱	jghw
𱇻	wxpj
𱈃	wqvy
𱈌	wga
𱈌	wgag
𱉻	ybx
𱉻	ybxn
𱊊	eux
𱊊	euxn
𱊌	ccx
𱊌	ccxn
𱊬	yncx
𱊳	qqqx
𱌮	lgj
𱎼	jtg
𱏿	wdk
𱑞	xlw
𱑞	xlwr
𱖇	geg
𱖎	gtmd
𱖒	gfpg
𱗩	giu
𱗩	giuc
𱘩	zjvd
𱚦	ybm
𱛥	vqp
𱛥	vqpe
𱞍	thx
𱟛	sii
𱟛	siih
𱟻	upu
𱤏	eeee
𱥂	fsfs
𱫉	cpu
𱮒	mlj
𱮒	mlje
𱮸	ndp
𱮸	ndpe
𱯄	nwn
𱯄	nwni
𱯍	nzz
𱯍	nzzk
𱰛	lqss
𱰾	qsu
𱰾	qsun
𱳪	mmid
𱸇	rlws
𱸥	rip
𱸥	ripw
𱹍	pze
𱹍	pzem
𲀃	cvvv
𲄗	azs
𲄚	zpc
𲈗	zxn
𲈗	zxns
𲈵	aks
𲉅	axbd
𲋤	qpdk
𲍭	fsx
𲍭	fsxn
𲍿	zjvx
褎	tbfx
褏	tbfd
楙	itee
鬱	aeee
藥	liue
嚥	dlac
嬿	blac
䜩	slac
的	unid
一	fi
是	ots
不	cb
了	rl
在	nggt
我	tupg
人	jr
他	jey
这	vuc
有	nvy
个	jgs
大	md
上	yfi
中	dgs
来	ahb
地	gey
和	xdk
说	shdp
为	isid
们	jam
到	ypd
你	jxyx
就	gyoy
也	ey
以	vjr
国	rnid
那	aute
要	vbn
时	okc
出	smk
着	gqm
可	zk
道	houc
对	rkc
会	jby
而	le
得	wofk
下	fyb
能	kvvv
过	kuc
于	fns
年	evk
后	xfdk
发	srid
都	qote
没	krs
还	cuc
所	mtj
去	gks
看	uqm
事	fdbv
如	bdk
作	jwa
多	llx
行	px
只	dhb
好	bhi
成	nae
家	wjs
天	fmd
她	bey
然	vmch
当	ybj
起	pvj
种	xdgs
经	irug
现	nej
但	jofi
法	kgks
同	mfdk
么	tks
进	quc
学	kwhi
其	zhb
前	hvpd
主	inw
从	jjr
动	bsl
分	hpd
开	flc
本	efi
因	rmd
定	wts
部	idte
与	fafi
实	wwmd
意	xhx
知	odk
此	svb
第	rtf
很	wig
被	trp
它	wvb
明	ovy
者	qor
公	hks
机	eoj
向	tmdk
最	oqry
使	jfdb
全	jnw
点	ydch
情	havy
并	hlc
回	rdk
等	rgkc
头	wmd
声	gcs
应	xkfi
间	aor
话	sas
给	ijdk
美	gmd
真	nqhb
内	mjr
利	xpd
打	uad
新	ietj
位	jil
加	sdk
先	qpe
特	qgkc
才	ntp
太	mid
信	jsy
原	xuyx
更	fobi
己	vj
名	ldk
比	vvb
代	jpi
任	jtgs
次	weq
世	lae
提	uots
做	jchp
眼	qig
通	ktuc
感	nfdh
别	dspd
少	ytp
处	hyb
平	ehb
解	xtpq
何	jzk
反	xry
变	zcry
总	hdhx
认	sjr
条	hem
安	wbn
活	kas
数	pbhp
必	htp
指	uvor
张	bpc
报	uzry
员	dob
义	ibi
放	lhp
电	oae
建	buy
件	jqn
死	gvb
许	sens
题	otwy
场	gaes
空	eug
计	sns
怎	whx
德	wnyh
强	bdcc
务	hsl
嗯	drmh
书	aagi
市	zrj
师	pfrj
即	izj
克	cpe
带	lwrj
区	nbi
则	opd
交	abi
社	fgt
北	avb
展	clti
传	jmai
连	yuc
叫	dij
治	kkdk
万	fpd
告	qdk
科	xjd
思	qhx
达	muc
转	ymai
望	fvnw
边	suc
快	hnjr
色	xmb
该	skh
权	ery
拉	uil
取	qry
收	ihp
林	eem
根	eig
极	ecj
求	fkid
每	ekm
据	uccg
确	mxty
虽	dcc
失	thf
格	esg
远	mpuc
办	shb
改	vhp
英	lmmd
争	xbv
吗	dnm
院	twmp
轻	yrug
罗	ylx
百	fub
离	zbmv
花	ljvb
近	tuc
组	ifq
流	kboc
导	vkc
早	ons
找	upg
满	klml
服	vzry
官	wki
爱	ywnr
影	ogye
随	tnvu
吃	deai
商	imhd
证	sfsi
单	hqns
越	pnu
存	nghi
击	umk
精	pavy
台	kdk
集	uem
双	rry
半	hus
曾	hryo
啊	dtzk
阿	tzk
落	lksg
写	wfaf
倒	jypd
敌	ahp
朝	nonv
派	kxti
首	hoi
视	fej
况	wdpe
谈	scch
史	dbi
须	ewy
器	ddmd
留	bqt
推	uui
注	kinw
语	swdk
紧	pris
号	dfae
攻	uhp
专	maid
考	qfae
皇	unw
星	ols
刘	vpd
仅	jry
费	tob
仍	jvn
某	zem
列	gpd
讲	sqj
破	mrp
客	wsg
施	leey
节	lzj
钱	zfpg
维	iui
河	kzk
划	ppd
致	yhp
送	hmuc
够	gllx
段	ufrs
群	btdg
独	mcc
细	iqt
志	ghx
热	ukic
项	uwy
料	pjd
属	ctdv
验	njkf
境	gxpe
毛	vm
继	ipae
错	zlor
采	yem
否	cdk
股	vrs
帮	atrj
友	nry
铁	zthf
暗	oxy
左	nug
率	ziwn
承	akts
试	spug
药	lini
久	xid
哈	djdk
预	iwy
刻	kpd
诉	stid
简	raor
差	gug
异	vlc
警	lghs
排	urf
负	xob
酒	kyy
穿	ely
福	ffdq
怀	hcb
欢	req
环	ncb
脚	vgkz
疑	vokt
置	ynqf
右	ndk
层	cby
州	ooc
闻	aqe
玉	nid
哥	zzk
杨	eaes
兄	dpe
块	gnjr
配	yvj
姑	bcg
娘	biig
草	lons
姐	bfq
巨	nnk
免	wpe
养	gipd
顾	xzwy
份	jhpd
换	uxmm
登	hzd
犯	mzj
危	xxzj
审	wogs
掉	uyon
散	lvhp
魔	zag
永	iks
谢	szkc
逃	pwwu
岛	xvs
贵	cob
顺	owy
楼	epbn
遇	qvuc
良	iig
亮	goj
闪	ajr
互	fbj
鱼	wv
短	ozd
隐	txbh
付	jkc
败	ohp
朱	taw
缺	anjr
味	daw
杂	kem
翻	tpqz
雪	tbj
款	gfeq
央	mmd
版	axry
班	npnw
固	rcg
妇	bbj
烟	crmd
测	kopd
笔	rvm
饭	qxry
乡	ix
弄	nlc
忘	fhx
迎	bzuc
虎	zh
票	vfs
录	bks
炸	cwa
盘	iam
寒	wqhw
训	soc
卷	hhzj
骨	fg
拥	uty
疗	arl
睛	qavy
床	xem
蓝	lpra
弱	bwbw
轮	yjl
午	ens
窗	etrh
雄	nkui
醒	yols
甲	sj
灯	cad
努	brsl
萨	ltix
妹	baw
悲	rhx
宽	wlej
犹	moy
针	zns
夺	mkc
柳	ebm
乌	xu
雅	lui
贸	bob
趣	pqry
摩	zus
眉	cqm
袭	tti
汇	knk
售	udk
泪	kqm
彻	wrpd
摸	ulom
闹	azrj
汽	kvq
肩	mvy
尾	cvm
剩	xavp
恰	hjdk
奶	bvn
启	mdk
颜	ixew
翼	zqlh
鸡	rxn
躲	zoem
映	ommd
灾	wch
冬	hwb
码	mnm
劝	rsl
跃	ptmd
巡	ouc
欣	teq
蛋	tcc
吐	dgt
闲	aem
矛	itp
滑	kfg
曰	or
晨	ofc
酸	ykhh
凉	wgyx
嘛	dzm
戒	plc
菲	lrf
氏	bs
餐	grqs
踏	pkor
朵	oem
袖	tdy
尝	sby
醉	yzjn
弥	bxyx
堪	gzha
帽	roqm
唤	dxmm
糖	pxbd
档	eybj
聊	qbm
窝	edmj
卜	yb
拾	ujdk
璃	nzbv
甫	nf
踢	pone
耍	lbn
鸭	sxn
瞎	qwad
焰	cxpj
龟	wg
兔	wt
裹	tqem
祈	ftj
硕	mwy
肢	vci
凛	wzrf
咋	dwa
毋	ku
巳	vs
戊	nu
禾	xh
聿	bv
卯	bm
皿	am
卅	ls
臼	pj
頁	wy
黾	dm
缶	af
殳	rs
隹	ui
耒	al
芈	gy
爿	ap
鬲	ng
彳	wc
扌	us
〇	dk
の	ae
丨	gs
丶	id
丿	tp
亠	zt
亻	jr
亾	fw
冂	mk
円	vy
冫	wb
勹	nk
卌	lx
囗	rk
壴	hu
尢	oy
廴	uy
彐	bj
彡	es
攴	hp
朩	em
爫	ya
犭	mq
疒	ab
礻	fs
禸	vr
罒	ys
衤	ti
讠	sy
饣	qs
𠄏	rl
巎	vfsh
汩	korg
汨	korm
钋	zybp
隶	bksj
彔	bksj
帷	ruij
羔	gchy
邑	dmbk
耙	ambl
仃	jadr
戍	nidu
闩	afim
翟	zuiv
胥	tvys
隽	uvni
鏖	xzjl
臸	yyii
旰	oegr
犷	mxgq
𠕇	nvys
玊	nidw
沓	kors
乜	aaee
氽	jksr
珖	nmgw
町	qadt
耵	qade
弔	bgsg
桎	eyim
犴	megq
麂	xojl
毴	vrfm
硌	msgs
邙	ftew
珞	nsgw
汜	kvss
舫	ilfo
徉	wgyc
雒	suig
胲	vkhy
胛	vsjy
岬	vsjs
羖	grsy
蛭	cyic
饤	qads
犽	mlyq
鲱	wrfv
祜	fcgs
辻	nucs
鲂	wlfv
耄	qvml
眊	qvmm
帏	rgwj
怫	htfx
渑	kdms
蛄	ccgc
碓	muis
刖	vpdy
苴	lfqc
蛘	cgyc
畋	qhpt
罟	ycgs
裉	tige
蚰	cdyc
辂	ysgc
柰	efsm
酤	ycgy
蚆	cmbc
㶲	ctyh
䀦	qcgm
呴	dgjk
広	xksg
拃	uwas
砢	mzks
窅	eqmx
饹	qsgs
鲉	wdyv
鲏	wrpv
鲝	gwvy
𬯀	tqqe
𮯙	lzkc
钚	zcbj
鲕	wlev
魆	anug
鿬	mqts
峁	vbms
笕	reju
钿	zqtj
钯	zmbj
酐	yegy
習	zubv
叻	dslk
邝	xteg
鄜	xtel
邡	ltef
钐	zesj
耔	ahil
脒	vpmy
炣	czkh
迮	wuca
𫟷	zilj
翋	zilv
㻋	nxsw
䏡	vfsy
徂	wfqc
钬	zchj
厍	xycc
愐	hbmx
舁	plcj
忮	hcix
茑	lxnc
炆	cvwh
熿	cnhh
微	wvfo
赢	fdvo
徽	wvfi
嬴	fdvb
徵	wvfn
羸	fdvg
彀	gwfb
觳	gwfx
殼	gwfo
蠃	fdvc
榖	gwfe
穀	gwfx
縠	gwfi
𬆮	gwfx
砦	svms
個	jrc
個	jrcg
𱏱	jam
並	hcy
邛	ute
別	dpp
別	dppd
裏	tdl
車	ycc
車	yc
機	eiii
萬	lqv
萬	lqvr
辦	snnx
羣	btdg
養	gqs
團	rnq
團	rnqk
樂	iuie
價	jvob
蘇	lwxh
隻	ury
嬲	qsb
嬲	qsbs
嬲	bqss
廣	xnh
夔	hsoh
孑	rfil
汞	uksg
匝	nrjk
汆	jksu
旮	korj
趄	pfqz
舡	iugo
臝	fdvq
贏	fdvo
鬥	jd
蟲	cccc
疖	azjb
雱	tlfv
砟	mwas
気	vbiq
轪	ymdc
琲	nrfw
𬴂	nrfm
邛	uteg
紮	eais
舁	plc
箇	rrc
箇	rrcg
刍	xbjd
凫	xojn
颏	kwyh
東	eorm
祉	fsis
岣	vgjs
扦	ulqs
迓	lucy
𤆵	cmbh
敉	phpm
丼	qidj
鼫	pmss
辯	snnx
黴	wvfp
墫	ghy
墫	ghyk
夶	mmd
鲕	wle
𠬝	zry
𰉄	dqpo
𰪭	ppc
𰱱	lweo
㐄	vkk
㐄	vk
㐫	zbmk
㐬	boc
㒸	hjs
㓁	whb
㚅	hfl
㚅	hfls
㚐	mmd
䍃	yaf
䛐	afds
䠀	pss
䵤	flph
丂	fae
乭	mai
亇	xgs
儍	jpmh
冡	wfj
冡	wfjs
凢	toj
凣	goj
卂	ans
叾	rdk
吅	ddk
咅	idk
唈	ddmb
啇	imc
啇	imcg
堦	gvvu
壿	ghyk
夋	khhi
夌	ghhi
姧	bbe
姧	bbeg
娰	bjvj
嫐	bqsb
嬥	bzui
尃	nkc
尞	mhoy
屰	hsc
巟	foc
巣	kqem
弜	bbg
弮	hhbg
掔	qru
掔	qrus
旉	nlf
晻	omo
晻	omoa
桺	ebm
楛	elc
楛	elcg
榝	ebe
榝	eber
欮	hse
欮	hseq
氷	iks
汙	kfn
汙	kfns
沬	kaw
泬	kex
湨	kqmq
炏	cch
烎	flch
爢	zrch
玊	nid
玨	nnw
珶	nhtf
瓱	rvm
畐	fdqt
癈	ahbr
礽	fvn
窌	ebm
筳	rtg
筳	rtgu
箠	rllg
篲	raa
篲	raab
篿	rnqk
粦	plvk
紥	uais
繣	ibq
繣	ibqf
罙	whem
臸	yyi
荅	ljdk
菻	leem
葹	llee
薆	lywh
虖	zthn
蜰	vmcc
踠	pwl
踠	pwlz
雔	uui
靆	tbbu
韮	lrfi
髣	pel
髣	pelf
髴	pet
髴	petf
鼱	pavy
齌	qch
𠂇	ns
𠕇	nvy
𠬤	rus
𡨄	wqhb
𡰪	cdk
𤯕	lbn
𥫗	ru
𥹂	pcf
𥹂	pcfi
𨂿	pcfs
𨑨	ouc
𫄨	ibnr
𫏋	ptmp
𫠆	cwy
𲂎	suu
𲂎	suub
襃	tbfe
裦	tbft
弻	frjb
棥	bbee
礬	bbem
讎	suui
𩁗	suui
𢦄	hsuu
嫐	qsbb
椕	hpee
㮟	meem
㯎	seem
轡	yiid
𨏯	zyid
壄	iteg
𣜓	itea
𣝥	itek
𦼪	lite
𧃺	litl
𧝺	tite
𧞉	itet
𪴈	itee
𭅩	siin
𭟄	siih
𭤛	siiv
𮜬	psih
𫰀	yiim
𢥩	yiih
𮝲	yiif
𰹫	gjbz
𮣩	eiiz
𦆕	yiis
虈	lwdd
𩱴	wddn
羉	ysii
䖇	laee
灪	kaee
爩	caee
𡯀	aeey
𡿥	vaee
𢺴	uaee
𣡡	aeek
𣡸	aeek
𤓮	aeec
𥘄	maee
𦉚	aeed
𦉠	aeed
𩏴	aeeg
𪓊	paee
𬅍	aeeu
𬅔	aeez
𬰸	aeeg
㮊	ieem
𡐨	ieeg
𣛾	ieek
𨬮	ieez
𪺂	seec
𫻓	seeh
𣁩	veek
𩰩	veek
𪴦	veek
㘜	suud
犫	suuq
𠧐	suun
𠞢	pnnp
𠺚	dpnn
𢲔	upnn
𢴬	uvnn
𣗝	epnn
𤡰	mvnn
𤤻	pnnw
𤦦	hpnn
𦶾	lpnn
𩔮	pnnw
𩺡	wpnn
𪄕	pnnx
𨫄	zpnn
𪉒	pnnx
𪱟	pnnv
𫋑	cpnn
𫫨	dvnn
𬂇	vpnn
𭨞	pnno
𭹚	gnnw
𭹞	hnnw
𰢁	jjnn
辧	pnnx
辮	innx
辬	vnnx
㦚	hnnx
㵷	knnx
㸤	annx
䉸	rsnn
𡅼	dsnn
𤀲	knnx
𥌊	qnnx
𥷁	rsnn
𨐰	hpnn
𨐱	vnnx
𨐵	htnn
𨐾	asnn
𪭀	pnnh
𰽑	znnx
𱺎	ipnn
㢽	qbbg
㣃	bvbb
䰜	nbbg
䰞	qobn
𢏺	fmjb
𢐁	ibbg
𢐆	ddbb
𢐌	xbbg
𢐐	ibbg
𢐥	vabb
𢐨	nsnb
𢐫	pbba
𢐬	vsbb
𢐲	tpqb
𢐷	hryb
𢐹	zrdb
𢐺	llfb
𢐼	qocb
𢐾	gjjb
𢑋	ddnb
𢑌	gcgb
𢑍	ekbb
𤑜	qobc
𤑨	qobc
𤑵	nsnc
𤳕	pbbq
𥪷	pbbi
𩅭	tfub
𩱌	inbn
𩱍	cbbn
𩱎	tbbn
𩱒	cznb
𩱓	qbbn
𩱖	xbbn
𩱗	ybbn
𩱚	nwhn
𩱜	fbbn
𩱞	qhbn
𩱟	ekbn
𩱠	ddnb
𩱡	jdon
𩱣	ktbn
𩱤	bubn
𩱥	kkkn
𩱦	nsnn
𩱧	gcbn
𩱨	fkbn
𩱪	ffmn
𩱫	xubn
𩱭	hryn
𩱮	knnn
𩱯	pbon
𩱰	qokn
𩱱	ekbn
𩱲	zubn
𩱳	qbbn
𩱶	tubn
𩱷	plyn
𪆀	pbbx
𭶡	npbc
𮌿	pbbj
𮫚	bvbg
𰘰	efub
𰘱	fube
𱆐	gkbn
𱆑	fmfn
𱆒	nfdn
𱆔	thtn
𱆕	lywn
嘂	iddd
嚻	wddd
𤣠	mwdd
㜰	biue
㦡	hiue
㰛	elie
䁻	qiue
䑈	viue
䟏	piue
䤕	yiue
嚛	diue
擽	uiue
櫟	eiue
濼	kiue
爍	ciue
瓅	niue
皪	uiue
礫	miue
纅	iiue
觻	xtie
躒	piue
轢	yiue
鑠	ziue
鱳	wiue
樂	iuie
樂	iuie
轢	yiue
樂	iuie
𠒴	iuip
𠘙	kiue
𡤤	blie
𡾒	viue
𢺇	ulie
𣀝	iuih
𣋵	oiue
𣡝	caie
𣡳	iuid
𣤰	iuie
𤄶	klie
𤄿	keie
𤓈	clie
𤢴	miue
𤻲	aiue
𤾾	urie
𥍐	qlie
𥽗	piue
𧆄	xlie
𧔉	ciue
𧭥	siue
𨰤	zlie
𩟧	qiue
𩧂	niue
𪇱	iuie
𫿾	iuit
𭀅	jiue
𭧡	iuio
𮁚	mlie
𮁏	miun
𦘈	qiue
𰙂	iuip
𱿌	liux
㨮	ubup
𣘛	ebup
𦄓	ibuo
𩮷	pebp
𱔍	dbup
兠	auvp
𱏫	auvp
橷	eaup
𠙩	afui
𠙯	lauo
𡕸	hauh
𦿵	lauv
𭳨	khah
曣	olac
讌	slac
酀	ladt
醼	ylac
驠	nlac
㬫	lado
𡤈	lacb
𣟛	elac
𤃇	klac
𤒈	clac
𧔦	clac
𤓨	ladb
𤫇	nlac
𥍂	qlac
𥗕	mlac
𥷀	rlac
𥽫	plac
𨇟	plac
𨯧	zlac
𨽞	tlac
𩽒	wlac
䴏	ladx
𱊴	ladx
𪈏	ladx
臙	vlac
𫿲	vlac
𭗬	vlac
𭣅	ulac
𮨤	ladw
𮩘	qlac
𱅬	nlac
巙	vhsh
夒	fsoh
犪	qhsh
獿	mfsh
虁	lfsh
躨	phsh
㹛	qfsh
𠑍	jfsh
𠑚	jfsh
𡖂	lswh
𢅼	rfsh
𢆃	rhsh
𢥝	hfsh
𢺕	ufsh
𤫕	nfsh
𥜶	fhsh
𧅄	lhsh
𨈉	phsh
𩵊	alsh
𪭆	hhsh
𪺈	cfsh
𭐱	hsoh
嘷	dokn
噑	dukn
暭	oukn
曍	ookn
槹	eukn
橰	eokn
獋	mokn
獔	mukn
皐	ukns
皡	uukn
皥	uokn
翶	uknz
翺	oknz
臯	okns
鷱	oknx
䝥	mokn
𠦂	kns
𡠖	bokn
𡼗	vokn
𢡋	hokn
𢿎	uknh
𣽎	kokn
𤩢	kokn
𤺃	aokn
𥢐	xokn
𥴚	rokn
𦟞	vokn
𦺆	lokn
𧞠	oknb
𧢌	okne
𧬁	sokn
𧯌	hokn
𨎦	yokn
𨝲	oknt
𨼍	tokn
𩀹	oknu
𩏤	gokn
𩕍	oknw
𫽿	uukn
𭕝	ckns
𭿟	qokn
𮊳	gokn
𮤤	aokn
𰶅	sokn
𱨔	kykn
𮰋	iuio
𮰪	gbup
嗀	gwfd
幑	wvfr
瑴	gwfn
瞉	gwfq
糓	gwfp
豰	gwfj
轂	gwfy
驘	fdvn
鰴	wvfw
鷇	gwfx
鸁	fdvx
㜌	gwfb
㝅	gwfh
㣲	wvfd
㲉	gwfb
㷤	gwfc
㺉	gwfm
䍍	gwfa
䐨	gwfv
𡑤	fdvg
𡢔	fdvb
𡳴	fdvl
𢕄	wvfi
𣎆	fdvo
𣜄	fdve
𣪒	gwfa
𣪨	gwfm
𣪳	gwfe
𣪹	gwfs
𣫌	gwfy
𣫎	gwfx
𣫓	gwfe
𣫔	gwfj
𣹬	gwfk
𥔳	gwfm
𥢵	fdvx
𦎯	gwfg
𦣄	fdvt
𦣉	fdvp
𦣖	fdvo
𧏚	gwfc
𧝹	fdvt
𧹲	gwfg
𨏩	fdvy
𨭞	fdvz
𩌊	gwft
𩼊	fdvw
𪏙	gwfn
𪕸	gwfp
𫢃	fdvd
𫢄	fdvf
𬢙	fdvx
𱈑	wvfw
𱊮	fdvx
嗀	gwfd
穀	gwfx
！	a
》	b
〉	b
】	c
〕	c
、	d
|	d
（	e
“	f
‘	f
”	g
’	g
『	h
——	i
—	i
』	j
￥	k
$	k
%	l
」	m
「	n
〖	o
〗	p
：“	q
：‘	q
）	r
……	s
…	s
→	t
~	u
《	v
〈	v
？	w
【	x
〔	x
·	y